102 104
......X....X..........XXXX.......X...XX..X....X.........XX....X.....X...XXX...XX.....XXXXX..X....XXX....
........X....X......X...X..XX....X.X.XX....XX.X............XX...XXX...X.X...X....XX..XXXXX....XX.....XX.
.....X.XX.X.......X.....X...X...XX....X...X...X........X.....XXX.....XX...XXXX......XXXXX..X....XXX...X.
.XXX...XX.....X...XX......X.XX..X...X...XXX.XXX.X...XX.....X...X...X...X...X...XXX.....XX.XX.XX.XXX.X...
.........X........XX...X..X....XX....XX.....X...X.X..X..XX...X..X..X.X...X........XX.X..X....XX.....XX..
X...XXXX.X...X....X..X...XX...X..XXX.......XX......X....XXX..XX....X.XX.......X......XX.XX..X.....XXXXXX
..X..XX..X.....X..X...X.....X.X........XX..X...X.X....X.X...X....X...XXXX.XXX......X.....X....X.........
.XXX....X........X..X...XXXX....X.........XX...X.X..X...X.XXX.XX.......X..X....X.....X.X.X...X..........
......XX..X...X....X......X..X.........XXXXX..XX....X..XX.XX..X..........X...X...XXXXX.....X...X.....XXX
XXX...XX.X..X...X.XX.XXXX...X....X.....X...X..X...X....X.....X..X...X......X.X...XX...X.XX...XXXXX.X....
X...XX.....X....X.....XXXX....XXXX.XX..X...X....X....X...X.X...X..X...XXX....X......X.X....XXX...X..XXX.
..X.......X..X....X.X......X..XXXX.....X..X..XXX..XX.......X..XX...XX..X....X...XX......X......X.XX...X.
.XX..XX...X.XXXX..X....XXXX...X..XX....X....X....XX..XX.....X......XXX...X....X.....XX....XX..........X.
..XX.XX........X...X........X....X..X..X......X..XX...XXXXX....XX.....XXXX...XXXX.X....XX..X....X.XXX...
X..X.....X...X...X......X..XX..X...XXXXXXXXX.....X..X......X......XXX..X..X.......X..X.....XXXX...XX....
...X..X..X...X....XX....X...X.....X..XX....XXX.X...X...XXX.X...X.....X....X.X........X.XXX...XXX.....X..
.XXXXXX.X..X.........X....X...XX..X.....XX..X..XXXXX.X.XXX...X...X.X....X........X........XX.XXX.XX..X..
..XXX.....X...XX...XXX...XXX.....XX...X..XX...XXXXXX...X....XX...X.X..X....XX....X....X...X..X...X...X..
X.....XX....X......X...X.....XX..XX.............XXXXXX....X........XXXXX..XXX.X..X.XXX......XX...X.....X
...X..X.......X......X.X....X...XX...XXX...XXXX..X......X.XXX...XXXXXX....X......X...X.X.........XXXX...
.X..XX..XXXXX.....XXXX...X....X.X..X.XX..X...X...X....X...XX..XX........X...XX.....X..........X....XX.X.
.XX.XX...XX....XXXXXXX.....X....X.......XXX....XXXX...XX..XX..........X..X......X...X...........XX....X.
.........X..XX..XX.........XXX......XX......X.X.......XXXXX.......X...XX..XX.XX...X...X..XXX...XXX..X...
XX...X.....XXXX.......X.....XX...XX....XXX....X.XXXX..XXX...XXXXX...X..XX..X..X..XX...X.....XX.XXXXXX.XX
X..X...XX.......X.X...X.X.X....X....X..X...XX...XXX..XXXX.XX......XXXX..XX....X.........X...XX.X....X...
X.....X.....XXX.X...X...X....X.....X.....XX.......X.....X....XXX......X................X.......X.XX.XX..
....X.X.XXXX....XX......XX.XX...XX.X....XX..........X........XX..XXXX.XX..XXXX.X.......X.X.......XX....X
......X.X......X.....XX.XX.XX.X.......X....X.....X..............X.....XX....XX...X...X...XXX....XXXXXXXX
XXXX..X...X......X...X..XX.....XX...X.XXX....X.X.....X....X...X......XXX.........X.......XX..XX.XXXX....
.......X..X...X....X...XX....X..XXX.....X.XX.X.........X....X......X..XX...XX.......X.......XXX....X.XX.
.XXXXX.XXX....X.X.....X...X...X......X....XX.XX.....X....XX....X...XX.XX........X.X.....XXXXXXXX.....X..
..X....X...XXX....X...X.....X..........X.....XX.....X.X.XX...X...X...........XX...XX...X.........XX....X
X...X..X.......X.....XXXXXXXXX......X.....X..XXXX...X...XX.X.X.....X.X.........X..XX.X.......XX.....X...
...X..XXXXXXX..XXX.X.XX......X...X......X.....XX..X..........X.....X...X.....X....X.....XXX..XX...X...X.
...X....XX.......X....X.XXX....X...X....X..X..XX....X...X.....X....X..XX.....XXXX...X.X.....XXX...XX....
..XX.......XXXX.....X...X...X.........X.XX...XX.....X.X.XXXXX.X.X..X..XX....XXXXXX....X.XX....X...X....X
..XX...X.....XX.X....X....XX........X.X.........XXX.X.X.XXXXX.....XX.....X.........X....X..XX...XXX.X...
..X..X...XXX.X..XXXX.X...XXX........X.......XX...XX...X.XXXX...X.....XXX...X.XX..X.XXX..X...X..XX.....X.
..X........X...XXXX..X...XX....XXXX....X....XX.X...XX...XXXX...X...XXXXX.....XX..X.XX....XX....X.....XX.
...............XXXX.........XX...X...X...XX.X..XXX......X..X..XX.....X......X....X.X..XX.X...X...X.XXXX.
...XXXX.....XX.XXXXXX.....X........X...XXXX...XXXXXX....X..X...XXXXX....X......X...X.......X.XX....XXX..
....X...X...............XXX.XXX........XX..X..X...X..X..X....X..XX....X.X....X....X.....X..X....X......X
XXX........XX.X.....XXXXX...XX..XXX....XX..XXXX.X.X.....X.....X....XX.....XXXXXXX...XXXX...XXXX.X.....XX
..XXXX...X.XX...X...XXXXX..XXX......X...X.......X.....X.....X.X.......XX...X.......XX....X.X....X.....XX
.......X....XX....X..X...X.......XX...X...X......X.....X......X.XXXX..X..X.......X....X....X...XX...XXXX
...XX.....X.X..X..XX.....XX....XXXX....X..X...XX.X...X....XX.XX.XX....X.....XXX..X..XX..X.......X.X.....
...X..X.......X..XX...X..XX..X......XX....XXX..X........X.XX.....X......XX......XX..XX........X.X....XX.
.X...X..XX...X..XX..X....XXX.......XX.....XXXX...XX............X.....X.XX..XXX..XX...X.XX..........XX...
.X.XXX.....X...XXX....XX..XXXX......X.....X......XXXXXXX...XXXXX..XX.X....XXXX...X.X...XX.X..X...XX...XX
...XX..XX..........X....X..XX.....X.......X...X....XXXXX.....XXX..XX........XX.X.X....X.....XX.......XXX
..XXX.X.....X...XX.X.......XX.X......X.....X....XX....XXXXXX.XXX..XX..XXXX..XX......XX.............X....
......X..XX...X..X..XX........XXXX...X.XXX...X...X..X...XX...X.....XX..X...XX...X......X.....X......XXX.
...XXX...XX......XX...........XX...X....X...X....X..XXX....X...XXX.X...X....X.XXX...X....X.....XXXX.....
...X...X.....XX...XX.....X....X..X....X...X...XXXX....X........XXX.X.X....X.X..XXXX...X.....X....XXX..XX
...........X....X..X.XXX.X.X..X....XX....XXX....XX....X..XXXX..XX..X.XX...X.XX.X......X...X...X....X....
XXXXX...X..X..XXXX...XXX.....X......XXXX......X...XX...X........X.....X...X....X.XXX....XX......XX...XX.
..XX..XX..XX...XX..XX..........XXXX.....XXX.X...X....X.X..X...X.XXX.X...X....XXX.XX..X.....X..........X.
...X.X...X...X........X.......XX.....XX...X.......X..X..X...X...XX..XX.....X..XX..X.....X..XXXXXX.....X.
.X.X....XX....X.....XXX.XXX.X....X.X...........X.....XX......X..XX.X...X.X..X.XXX.....X...XXXXXX..X.....
.X....X.......X.X.........X...X..X.....X.......X.X.X...X...X....XX.......XX.X...XXX.........X..X....XXXX
..X....XX...XXX........X......X.....X..XXXXXXX.....X.......X..X.X...X...........XXX...XX.XX.X....X......
X...XX....X..XXXX...X....XXXX.X...X...XXXXXX....X.............X...X.X......X.X...........XX.X.XX...XXX..
..........XX.X....X.X.X...XXX...X.X..XX..XXX.......XX....XXXX....XX.....XX.X.......X..........XX..XXX..X
.X........XX......X.X...X..XXXX.X.XX......X...XX.X....X....XXX....X..XX..X....XXXX.......X...XXX..X...XX
.X.XXXXXXXX...X...X......X....X...XXX...X...X....X..X...X...X...X.....X..X.....X..XX.......XX..XXXX.....
...X..X..XX..........X.X....X..X...XX.X.XX.....XXX......X.X...X..XXXX....X...X.........XX............X..
X.....X......X.....X......X.XX...X......XX...X.....X......XX..XX...XXX...XX..XXXX...X..X.....X....XX...X
X.X.....XXXX.X.....XX...X........XXXXX...XXX....X......X......X.......XX....XXXX..X.X....XX....XX.X...XX
X......XXX.......XXXX......X.....XXXXXXX......X.....XX......X...X...X....X.....X......XXXXX.X.......X...
.....XXXX.....X..........X....XXXXXXXXX...X......XXXX.....X....X..XXXXXX...XX..XXX..........XXXX.....X..
.XXXX.....X.X......XXX......X.XX......X.X..XXX........X....XX..X......XX......XX..XXXXX...XXXXXX..XX.X.X
.XX.....XXX....X...XXXXXX...X....XX...X.XX..XX........X....X..XXXXXXX..X.XXX........X...X.....XX.....X..
.X...X..XX...X....XXXX......XX..XX....X...X..X.X......X.X....XX......X...XX..X...XX...XXXX....XX......X.
...X.X.X...X....X....X..........X..X....X.XX...X..XXXXX.....X...X....XX.....XX.X.XX......X.X..X...XXX.X.
X..X...X.X....XXXX......XXX..XX...XX....X.......X........XX.X.XXX.XXXXX...XXX..X.........X...XX.X.....X.
X......X....X.........X..XX...XX..XXXX.....XXXX..XXX...X......X.......X...X...X..X........XX....XX..XX..
..X.......X...........XX....X....XX....X......XX.....X...X.X.....XXX....X..............XX...X.......X..X
......X...................X....X..X......XX.X..XXXX.....X..X...X..XX.X.....X.X....XXXX....X.........X.XX
...X....XX....XXXXX...X........XX...XXX...X..X...XX.XX..X...XX.XX....X...X.X.X..........X....X......X...
.XXX.X...X.XX....X..X....X...X..........X....X....X....XXXX......XXXXX.......X...X....X........XX...XXX.
..XX.X.X.X.XX..X...XX..X.XXX.X.X...X.......X....X......XX...X.X..X.....XX.XX.......X..XX....XXXXXXX...X.
X....X.....X...XXXXXX......X...X...X.XXXXX...XX....XXX.XX.....X.XX.XXX....X..........XXX........X.....X.
X..XX...X....X...XXX..X.XX....XX.X........X....X....XX.....X.......XX.......X....XX....X...X....X.......
X...X.....X....X.....XX..X..X..X....XXX.....X..XXXX..XXX.......X......XXXXXXXXX.....XX...XXX..XXXXX..XXX
X.X.X...XXX....XXX..XXXX....XX....X..XX..X.XX.XXXXXX........XXXX.....XXXXXX..X..X..XXXX.....X.X...X.....
..X...X...XXX...XX...X....X.....X....XXX...X..XXXXX...X...X....XX......XXXX..X......X...XX..X...X...X...
...XX......XX.X....X...XXXX.X...X..XX..X..X..XXXXX..X...X...XX.XX..XX....XX......X....X....XXXXXXX..X..X
XX.......X....X.......XX..X...X........X..X.XXXXXX.XXX..XX..XX.XXX....XX....XX.....X.XX...XXXX......XX..
.......XXX..XX..XXX.......XXX..X....XX..X...X....X...X.XXX.....X.......X.....X....XX..X......X.X....XXX.
.XXX....XXX....XXXX.......X..X...X......X.XXX.XX.....X.X...X...X....XX.....X.XX.......X....X.X......X...
.....XX..XX.X.......X........X.....X..........XX..XXXX...X...X..X...X...X..X.....X.......X...X..X...X.XX
XXX..X...XX.X..............X...XX.....XX...XXXX.....XX......XXX.X.XX..XX..XXXX.X.......X.....XXX....X...
..X..X.X..X...XXXXXX...X......XXX...X....X..X.....X..X....X.XXX....X.....XXXX..X..XXX....XX....X.....X..
..X..X....XXX...XXX..X....X...X...X..X......X..X.....XX.....X....X...XX.......XX...XX...XXXXX....XXX...X
........X..XX...X...X..XX.....X......X..X...X..X.X....X.XX..X...........X........X...XX....XX.XX.......X
...XXX..XX........XXX.X...........XX..X..XX....X....X......X...XX.....X.......X....X..X..X..X..X..XXXX..
.XX....X..XX...XX...X...X......X....X..X.....X..X......X.X...X....X......X.XX.X.......X...X....XXXXX..X.
....X..X.....XX...X.X..XX.XX...X.X...X.X..X.....X..X.X.X....XXX...X....X.X..X...X.XX....X.X.....XX....X.
XX....X..XX.......X....XX.XXXX.....X...X..X.X....X.X......XX..X.XX..XX...XX..X....XX.X..X...XXX.XX....X.
...X..X.....XX....XXXX....XX....XXXXXXXXX...XXXX...XX...XX....X....XXX..X....X.X.....X..XX....X.......X.
.....X......XX....XXX.....X..X....X...X.....XXX....XX...XX.XX..XX...XXX...X..........X..X..XX.XXXXX...X.
XXX..X......XXXX..XXX.....X....XX...X...XX..XXX....XX......XXX....X.........X........X..X.....XXXXXXX...
