105 107
XXX...X.....X.....XXXX..XXXX..XXXX...XX....X....X....XXX....X..XX.....XX........X..XXXX......X..XXXXX...XXX
....X...XXX.X...X..XX...X.....X....X....XX...XX.X..X.....XX....XX.XXX..X....XXX....X......XX....XXX...X...X
.X..XX......XXX..X....X.X...X...X..XXX..X....XX.XX....X.....XX.......X..X...XXX..X...X.X.....XX.X.......X.X
...X...XX...XXXX......X.XXX.XX.........XX....XX.XXX...X...X.XXXX.XX.....X...XXX..XX....X.X.X....X..X......X
XX.X......X..XXXX.....X.X...X..X................X....X..XXX...X..XX.X........XX....XX....X....XXXX...X.....
XX...........X....XX..X.....X.X.......X.XX.........X.X...XXXX...X...X..X...X....XX......X...X....X....XXXX.
....XXXXXXX..X......XX...X..X...X...X.X........XXX.......X.....XX..XX...XX..X....XXXX...X.X......X..X...X..
..X....XXX...XX......X.X.....X..XXX.......XX...XX..XX.XXXX..XX..XX....X...X....X..X...XXX....X...XXX......X
X....X..X..X.......X...X..XX..XX...X...X...X.XXXX.....XXXXX...X..X..X..X.....X.XX.X..........X.X..X..X.....
...X..X...XXXXXX...XXXXX..XXX....X...X...X........X...X..XXX.....X.....X.X.....XX....X...XX....XX...XXXXXX.
.X.XX....XXXXX...X..........XX......XX.XX...X.......X....X...X.....XXX....XXX..X..XX...X....X..X...X..XX...
...XX..X.XX..X.X.XX....XXXX.......X....X..X......X..XXXX.........XXX..X.X...X..X......X..X..XXXX...X.....XX
XXXXXX.......X.X.X..XX...X....XXX...X....X...XX..XXXXXX.....XX.....X..X..XX...XX...X..X........X..X..X.....
........XX.....X...XX......XXX.......XX....X....XXXXXX..XXXXX......X.....XX......XX..XX...XXX..X....X..XXX.
......X.X...X.......X.X........X...X........XX..XX..XX...XXX..X......XX......X......X...X.....X..XX...XXX..
..X.....X.X...X...X.........X..X.X....XXXX.......X.....X.....X...........X.........X..XX.....XX...........X
..X..X..........X....XXXX...X..X....X..XXX.X.XXX.X.X.........X...XXXXX.X......X....X.XX..X.X.....X...X....X
...X.XX..X.....XX..X....X..X......X....X.....X.....X.XX.XX...XXXX......XX..X....XXX..X..X..X..XX..XX...XX.X
.X.X.XX.....XX..XXXX.XX..X...XX....XXX....X.....X....X..XX..X.....X........X.X..X...XX.X..X.....X.X.....X..
...X....X.......XX.......XXX.....X....X...X.X...X..XXX....X.X.....X....XXX...XXXX........X..XXX.X...XXX....
..XXX.....XX........X.XXXX...XXX..X.....X.....X..X.XXXXXX...X...X....X............XXX...XX.XX...X........XX
....X...XXXX....X.X.X.X......XX...X.....XX.......X............X.XX...X..XX..X.....X...X.....X.......XXXX..X
.XX..X.......X..X.....X..XX..XX.........XX.....XXXXXXX...XX..X..XX...XXX....X..X..X.......X......X........X
.XXX...X.X.....XXXXX...X..X..X.....X.....X...XXXX......X...X...X...XX....XX.XX...XX..X.X.....XXX...X.XXX...
...XX....X....X..X...X.XX......XXX.....X...X..XXX.....X....X.XXX......X..XX.XX....X....X...X..X....X.XXX.X.
....X...XXX...X..X.X.X.X...X..XX....XXXX......X..XX.....X........XXXXXX...X.....X...XXX.....X...X....X.....
..X...XXX.....X....X...X.X....XX..X..XXX..X......X..XX........XX....X...X....XX.XX......X.X....XX...XX.XX.X
XXXX....X..X..X.X...X....XXXX...X.XX.XXX..X.XX...X.XX....X....XXX.....X....X.XX......X..X.X..X....XX...XX..
.....XX.XX.XXX..X.X.X.X..XXXXXX.X.X..X......XXXX...XX.X.....XX.......XX.XX........X..X....X...XX.......X...
...XXXX......X....X...X..XXXXX..X...XX..XXXXXXXXX..XX...XXX....XXX...X....X...XXX...XX......X....XXXX..X.XX
.........XX...XX.........XXXXX.......XX.......XX..XX....XX.........X...X....XX.....XX..XXX..XXX...X...XX..X
....X....X..X.XX...XX.......X........XX.......XX.....XX....X..XX.......X.XX....X.X.XX......XX...X...X.....X
..XXX...XX.......X.....XX.....XXXXXX..X......XX..XX...XX......XX..X......XX...XX.X.XX...XX..X......XXX..X..
....X..........X.....X.XX..X...X......X..XX..XX.....X..X.XXXX...X.XXXXX....X.....X....XXXXX...XX.X......X..
.XX.X..XXX...X....XX....X....X....X...XXX...XX.......X.X.XXXXXX.........XX...X....X.......X......X....X....
..X.XX...X.X..........X...X.....X.XXX..X..XX...XXXXX.X......X....X..............X.X..XXXX....X....X...XX...
X.X..X.X...XX....XXXX....XX.X.......XX...XXX..................XXXX.X...XXX....X...XX....XXXX...XX.....XX...
X....X.XX..XX....XXX...XXXX.............X....XX.....X......X....X..XXX...X..X..X...X..X.XX..XXX..........X.
XX.....XX..XX....XX..XXXX....XXXX..XX...X.X.....XXX.X...X.....X...XXX..X..X.XX...X..XXX.....X...X....X.....
......XX..XX..X.....XXXX...XXXXXXX.....X..X.X....XX...X...XXX...XX..X...X.......XXX.XXXX......X....X......X
..X.X..X...X....X....X...X.XXXX....X.X...XX......XXXX....XXXXX..XX....X...XX.XX...X.X....X.......X..X...X..
X...XX...X...X....XX.....X.XX....XX..X..X..X.....X....XX..XX...XX..XXXXXX....XX.....X.X..XXXXX...XX...X....
XXX..X..X...X..X...XXXX..X.X...X..X...XXX..X...X.X.X....X..X..XXX...XX...........XXXX.X..XXXX....XX.....XX.
.....XX...X...XX.X....XXX..X.X.XX...X.XXX..XX..X...X.......XX....XX.XX.X.......X..XXX...X..XX.....X..X.....
.X...XX...XX.....XX...XX..X....XX.....X....X..XXX..X...XX...XXX..XX....X.....X....X.....X....XXXX.XX...X.XX
.XXX......XX...XXX.....X....X.XX...XX...XX...XXX..X....XX.X.....XX.....X...XXX............X..X....X....X.XX
.XXXXX....X..X..XX.X.X..XX..X....X....XXXXX.........XXXX..X....XX..X...X.....X.....X.....XX.XX.XX...X..X..X
......XX..X..XX....X..X.....XXX.............XX.....XXX...XX.X.....XX..X......XXXXX.....X.......X....XXX...X
X........XX.....X.....XX....X.....XXX..X...XX..X.XXX....XXX.X.X.....X...XXX.........X.....XX.....X..XXX....
..XX...X.XX.X...XXX......X..X.XXXXXXXX...X....XX..X...X.....X.......X....X..X..XXXX...X.X.....X......X...X.
.XXXXX....X....X...XXXX..XXX..XXXXX........X....X...X....X..X..XXX....XX...XX...X....XX..X......X.XX...X...
...XX...X....X.............X....X.....X....XXX.........X....X...XX...XXXX..XX.X...XX.....X...X....X...XX..X
......X....XXXX...X.XXX..X...XX....XX...X....X...........XX.....XX....XXX..X..XX...............X....X......
..X......XXX........XX...X......XX........XX..........X..X...X...X..X..X...X...X.XX..XXXX...X....X......XX.
.......X.X...X.........X......X....X...XX...X......XX.X..X.....X....XX...X...X.X..XXXXXX..XXX.X......XX....
...XX....X...X.....XX.....X...X..X...XXX..X......X.X............X....XX......X..X.XXX..X...XX...X.....X..XX
XXXXX.X..........X..X...X...X..X.........X...X...X...X....XXXXX..XXX............X...X......XX......XX.X...X
......XXXXX...XXXXX...XX.......X......X..X.....XXXX..XXXX...X..X.......X....X.........X.....X..XXX....X...X
.....XXXX...X...X..........X...XX...X...X......XXX....XX..X....X............X.XX.........XX......X..X......
..XX......X.XXX......XX.XX.X...X..X.XX....XXX......X..XX..XX...X......X...XXX..........X.....XXX....X.XXXX.
..XX..XXXXX.XX.....X....X....X.X.XX....X......X.X....XXX....XX.XX..XX.XXX..XXX.....X......XX......XX..XX...
X...........X..XXXXX......X..X......X.......XXX.....X..X.XX.XX.X...X..XX...X...X.....XX...XX.........XX..XX
....X...XXXXX...XX...XXX..X.......X...XX.....X...X..X....X.....X.X...X...XX.......X.....X....XXXXXX..XX...X
.X....X.......X........X..X........XX....X.X...XXX.X..XX...X.X.....XXX......X...X.....X.....X.......XXXXX.X
.X...XXX........XXX....X....XXXXXX......X..X....XX.X.......X........XXXX...XX...X..XXXX.......X........X..X
...XX.....XXXX....XXX.............XX....X.......XX.....XX.....X...X......X.XXXX.X..X.........XX....X.X.X.XX
..XX..X.X...X..XX.......X..XXXX...XX......X......XXX...X..XXX.....XXX..XXX......X......X......XX.....X...XX
XXXX.X..X.....XXXX......XX.......XX....X..XXXXXX..XX..XX.XX....XX...X..XXXX...X...X.........X.....X.......X
.....X.....XX......XX......XXX.X....XX...XX..XXXX...X....X.....XX.X....XX...X....XX...X......XX.X......XX.X
....X....X.......XXXXXXXX..XX..XX...X...............X..X...X.XXXX....X....XX...X.XX.X......X....XX........X
X...X......X.X.............XX...X.X...X.X.....XXXXXXX....XXX..XXXXXX.....XX..XXX.X..X.XX...X..XXX..XX...X..
X......XX..X......XXX...X..X..X.....XXX...X....X......X.......X..XXXX....X..XX...X.........XX.....X...X....
...XX........XX.XX....X...XX..XX....X......XXX...XXX....X.....X..XX.....XX.........XXX.....XX....X..X..X...
.X....X.........XX....XX..XX..........XX.....XX........X..X...X..X........XXX...........XX..X..X...XXX.X...
...X......X......XX......XXX.........X....X.....X...X..X.XXXX....X.X........X.......XXX..XX.XX....XX.....X.
.....X.XX.XXX..X.......X.XX......X......X.X.......X....X...XXXXX...X.....X....X.......XX.XX.....XXXX.XX....
..XX...XX.XXX......X...X....X........XX........X....XX..X..X....X..X...XX..X..XXX...X.....XXX...X....X..XXX
X...XX....XXX.X........XX.....XXXXXX.....XXXXX........X.X.XX.......X.X....XX......X.XXX.X.....X.....XX.X...
X.X.XX.X....X.X...X....XX....XX...XX......X..X..X..X....X......X...X...XXX...X........X....X...........X.X.
....X....X....X......X..X..X.XX.X.XX.XXXX....X...X...X...X...X..XXX.....X..XXX.....XX.XX...X.X.......X.....
.X....X....XXXX..XX.....X.....X......XX..XXX...X.......X...X.XX.....X.....XXXXXX...XX....X.......X......X.X
.....XX.....XXX..X..X.X.....X....XX...X...XXX..XXXX.......XX...XX.....XX.X..XX...X.XX.........X.......X.X..
.....XX...X..XXXXX.X..X..X.....XX.X.X...X...X..XXX....X........XX....XXX....X....X.......XX.X...X..........
....XX..X....XXX...X.....X.XXX..X...XXXXXXX....XX..XX....X.........X......X...X..XXX.X...XX......XXXXX.XX..
..X....XX..............X......X..X....XXX....X..X.X....X.......X.XX...XXX..XXXXXX..X...XXX.....X..XX...X...
.....X....XXX...X...XX....XX..XX...XX.X.......X.X...XX....XX.....XX.X....X..X...X..XX..XX..XXXXXX....X...X.
...X.......X..X...X...XXX....X..X...X...XX..X.X.....X...XX....X.X......X.XX...X.X...X.....X..XXXX..XXX..XX.
X.....X..X...XXX....X..XX...XX....X.XX..XX....X..X....XXX...X...X.XX.X.X.XX.......X...X......X..X....XX....
X...X....XX..X...X...X.......X...X..XXXX...X.....X.X.XX...X..X.......X.X.XX..X.....XX......X....X....X...XX
.....XXX.....X.XX..X.......X...XXX.XXXX..X...X.......XX.XXXX...X.........XXX.....X..X..XXX....X.X......X.XX
.X.X.......X...X..XX..XXXXXX....XX......XX...XXXX.XXX.........XXXXXXX.X...XX..XX.XX.X....XX...X........X...
.X....X....XX..X...XXX..XX......XXX.............X..X..............XX..X.X.XXX....XX....X.....XXX.XX....XXX.
....XXX.X..XX......X....XX..X...X...X.....X.X...XX...X.....X...XX.XX....X.X...X..X...X.....X.XX..XX.X..X...
XXXXX.....X...X.X....XX.X...X.X.......X.....X..XX...X....X.X...XX.......X......XXX......XXXX....X...X..X.XX
....X..X....X...X..XXXX...X.X.XX...XX....X...X.XX.X...X......X.....X.........X....XXX...XXXX..X.....X..X...
.XX....X.X.XX..XXX.......X..X....X.....X...X......X......XX....X...X.XXX.X....XX..X...XXXXX......X.....XXX.
.XX..X...X..XX..XXX......X...XXX...XXX........XXX......X....X..X.........X.XX.X..XX....X..X....X.XXX.X...X.
..X.....X...X...XXX.X...X....X.....X....X......X...XXXXX..XXX.XX....X....X.XX...XX...X....XX...X.XXX.......
X...X...X.XXX.X.XXX...X.X.X.....X....X.......X...X..XXXX..XXX..X......XX...........X....X....X...XXX..X.XXX
X..XX...X.XX..X.X....XX...X.X.X.X.XX...X..........X..XXXX...XX.....X..X...X.X....XXXX......XX....XXX..X...X
XXXXX...X....XX...XX...X....X...X.XX...X...XX.X......XX...X.XX..XX...XX.....X.XX..X......X..X....XXX......X
............XX...XX....X.X..XX..X........X.XX.X..X....X...X..XX.......X..X....X...X.XX...XX......X...X.....
.X...X.........X..X......X..X......XX...XX..X..X....X.....XX....X...X.X...XX....X.....XX..X..X.....XXX.XXX.
...X..XX...X....X....XX.......X..X.XX....XX..X.X..X....X.....X...XX.X.X.X....X.....X...XX..XXX..X..........
..XXX....X......X..X......XXXXXXXX.......XXX...X..X..X.....X...X....X...X..X.....X...X.....XXXX.........XXX
