10 10
..X....XXX
.......X..
.X........
..........
X...XX....
X.XX......
X.XX..X...
X.........
..........
..........
