101 101
..............XX..X.....XX....X....XXXX...XXX....X...X..XXX...X..XXXX......XX......X.........XXXX..XX
.X..XXX....XX.....X..XX..X.XX......XXXX.X......X...X....X...X....XXXX....X.......X........XX.......XX
.X...XX.XX......X..X...X.....X.XX..X.........X.XX.....X........X..XXXX.........X..X.XX....XX.....X..X
...X....XXX.....XX........X....X...X...X.X.......XX.X........X....X....XX......XX.X....X.....XXX.XX.X
X...X...XX.....X...XX.......X....X..X....X.XX....X..X..X...XX...X.....XXX....X...........X....X.....X
X.X...X.X..X.X...X...........XX..XX...X....XXXX....XX....X..X.X....X..XX..X..XX..X......X..XX...X.X..
.....X..X.XX....X.......XX...X...XXX..XXX....XX.X.......XXX......X...XXX....XXX.....XXX...XXXXXXX....
.X...X........X...X...X.XX.....X.....XXXXXX...X...........XX...X........XX......X....X...X.......X...
.X..XX...X............X.........X........X..X..X.XX....X.....X..XX....X....XXXX....X...X...X.........
.X.....X...XXX.....XX.....X..XX.....X.X....XXX.X.....XX..X.X.XX.....X.X..XXX....XX..X..........XX....
...X....X..XX....XXXXX......X....XX...X.X....X....XX....XX........X.X....XXX....XXX....XXXX.XX.....X.
......X...XX..XXXXXXX..X......X.........XXXX.X..X....X......X..XXX.....XXXXXX....X...X..XX..XXX....X.
.XX.X..X..XX.XXXX.....XX.....XX...XXXX...X...X.....X.....XX....XXX.X.X.........X...X..X.XX.X....X..X.
....XX...XX..X...........X.....X..XX...X...X...X......XXX...XX.......X.......X....X...X....X...XX....
..XXXXX.....XX...X.....X....XX...XXX.XXX..X.......X.X.............X.....X......XX...X...........X...X
XXXXX...X.X...X..X.X......X.X......X...X....X.....X......X...X..........X.X..........X..XXX...X.X...X
....X..XX...X....X.X....X.....X........X.X..XXX..X...XX......X...X.XXX....X...XXXXXX.X..XXX.X.......X
.XX.XX......XXXX.....X.......XX.X............XX....X....X.XXXXX....X....XX..X...X...........X..X.XX..
.XX.....XXX......XX......X.X......XXXXX...XX....X....X..X.X..XX.X.....X..X....X.....X.XX...XXX.X.....
.XXXXXX....X...X...XX.X..X.....X.....XXXX..X..XX..XXXX..X.......XXXXX..X.X.XX.XX.X....XX.X.XX..XXX...
.......XXX...X.X....X...X........X....XX...X.....XX..XXXXX.....XXX...X.....XX.XX...X...X.X..X.XXX....
X......XX......X..X..XXX..XX....X...X....XXX.XX.........X....X...X.X....X.......X....X....X.......XXX
X.XXX..XX.XX......XX.XX..X....X...X.............X.....X.X.....XX.X....X....X......X.....X.XXXX.....XX
X.....XXX....XX...XX....X...X......X......XXX.....X......XXXX.......X....X.X...XX...X.......X....X..X
XX....XX......X....X......X....X.X...X.XX..X....XX.....X...XXXX...X....X.....X....XX...X......X..XX.X
XX.XXXXX.X.........X......XX.X.X..XX.X...X...X.....XXXXX........X....X....XX......X..X.....X....XXX.X
XX.....X.....X......X........X.XX.XX...X.X.....X.XX..XXX..XX............X..X........XXXXXX...X......X
XXXXX.....X......XX...XXXX.....XX..X.....X...XXX.X...X.........X......X....X...X...XXX..X......X.XX..
....X.X.....X.XX.X.......XXXX..X...X..X..........X.X......X.X..........XXX......XX......X.X.XX.X.X...
..X...XXXX..X..X...XXX........X..X..X...XXX...........XXX.X...X......X......X.X.......X...X......X.X.
X.XX..XXXX...X....X....XX.XXX...X...X.XXX......XX...X...........XXXX....X.....X..X....XX......X......
..XX..XXX..X..X.......XXX..XX..XX.X.X.XX..XXX..XXXX...XXXX.......X....XXX.XX...X.....XXX.XX...XXX.X..
.XXXXXXX..XXX....X.XX....X........X.X..X......XXXX..XX......XX.X...X..X...X....X.......X..X.XXXXX....
.X.....X.X...XXX.X..X..X.......X..X..X.X....XXXXXX.....X....X..XX.....X.XX..XXX.....XX.XX...XXX......
...X...X...X..XX....X...XXX..X.......X...XX.X......X.....X....X...X...X..X......X...XX......XXX.XXXXX
X..X..X..XX...XXX...X.X......X..XX....X.......X...XX.XX..X.XX...XXXXX..X.....X..X...XXX..XX...X...X..
...XX.X..XX.XXX...X.X.XX...X....XX.XX...XX.X....X.XX.X...X.X......XXXX..X.........XXX....XXXX...X.X..
.X....X.....X...XXX...X..X.X..X....XXX..XX...X..X.X..X...X...X.X..XXX...X.X...X.......XX...XX...X....
.XXX....X.....XX...X....XX.X........X.....X..X..X.X.XXXXX...XX...X..X.X...X.......XX..X....XX.....XX.
..XXXX.......XX..X...X...X...XXXX.....XXX...XX..X.X.XXXX..X.....XX....X.XXX....XX..X..X........XX....
X......X...X....XX.......XX...X......XX.........X...XXXX.....XX..X......XX..X...XX.XXX.....X...X...XX
...XXX.X...XXXXXXX..XXX.....X....X....................XX...X..XX.....X.....XX.X....X...XX....XXX.X..X
.X...X...X...XXXXX...XX.XX.....X...XXX...........X.......X....XXX........X........XX.XXX..X...XX....X
...X..XX...........X.......X.XXXX..XX....XXXXXXXX..XXX.XXXX.......X........X.X....X..X...X..X..X..X..
XX.XX.....X.......XXXX.X.....XXXX.XXX.XXXXX.......XXX..XXXX....XXXX..XXXX..X.X...XX.XX.XXX.....X..X..
...X...XX....XX......X....X..X..X...X..XX.......XX..X...XXX.........X...X....XX..XX.....X..XX.....X..
.XXX.X....XX.....X.X.XXXX....X.........X...X....XX....X...X...X.XXX...X.XXX.XXX.XX....X...X.....X....
...X....X......X.X.X..XXXXXX.....X.......X...X.....XX.....X.....XXX..XX..XX.X......X.....X...X..XX...
XX.XX...X........X..X.......X.....XXXXXXXXX....X....XXXXX......XXXX...XX....X.XX.XXX...X...X.X.XX....
......XXX...........XXXXX.......X....XX....XX.....X..XX...XX.X......X..X......X..XXX.....XXX.X.XX.XXX
..X.....X..XX.........X...XX.........XX.........X.XX..X...XX.......X...X.XXX..X...XX..XX.X...X....X..
X.......X..X..X....XX...XXXX.....X..XXX..XX.......XXX...........XX...XXX...XXX..X.XX..X....XXX..XXX..
...XX....XXX.XXXX......XX....XXX.X....X.......XX......XX...X...X.......X.....X....X.....X...X........
.X....XX.XXX.XX...X.......X........X..X.X........XX......X...X.....XXX.X..XX...XX...XX....X..........
.......X..XX..X.XXX.X........XX...X..XX.X..X...X...............XX..X...X...XXX....XX...XX.XX...X.....
..XXXX....XXX...XXX.XXXXXX.X.XX.....XXX.XX...X.....X.....XX.XX....XX.....X...X..XXXX.........XXX.X...
..X..X..X..X.....XX..XXXX..X....XX...X..XX......XX.X.X......XXXXX....XX....X..X....XXXXX.X.........X.
.....XX....X...X..XX....X.....X.X..X.X.XXX..X........X.XX.XX..XXXX......X.....XX...X...X........X....
..XX.....X..X.....XXXXX...X...X...XX.X.XXXX.....XXX.......X...X.......X...X....X..X..X....X..X....XXX
X...XX.X.XX...X.............X..XXXXX...X............X...X...X.X.X...........XX.XX.X.....XX...X.X...XX
.......X.X...XX........X.XX..X..XXXXX......X...X......XX....X...X....XXX.......X....X....X.X.......XX
.X.......X.X..X.XX.......XXX..X.X.....X.X....XX..X.....X.X.....X..X..XX....XX....X....XX......X.XX...
...XXXX..X.XX...XX....X.....X.X....X....X.X.....X...XX.......X.X....XXX.....X.X....X......X.....XX...
X.....X..X...X...XXXX.X...X......X.XXX....XXXX....X.XXXXX....X...XX.XX...XX...X...X..X......XX...XX..
..X.X......X...X...XX...X....X.......XXX....XX...XX........X..X........X...X..X.X...X....X..XXXX.....
.X..XXXXX....XX....XXX.....X....X....X...X.....X...XX.......X...X..X.........XX....XX.......XXX...XX.
.X........X..X..X....X.X...X..X.X......XXX.X.X...X.X..XXX.X.XX..X.....X...XX.X...X.XX...X.X.X...X.X..
.X........X....XX.XX.X.XXX..XXX.....X...X..X.....X...XXXX...XXXXX...X...X......X...X..X.X.....X.....X
.X.X......X.....X.XX...X..X..XXX......X...XXXXX..........X..XXX...XXX.......X......X.......X.....X...
...X.XXX.....XX....XXXXX.....X...XX..XXX..XXXX..XX..X......XXXX....XX.XX.XX.....X....X.XX....X...X.X.
.....X...X.X.....X.X...X...X.....XX..X...XXXX..XXX..X..XX....X...X....X..XX..X.......X....X..XXX.X.X.
..X....X...X..XXXX...X.X...X.XX...X....X.XXX..X.....XX....X....X..X..X..XXX..X.X.........XXXX..X.....
X...XXXXX.....XXXXXXXX...X......X...XX...XXX......X.....X...X.XXX.X..X...X........X...X..XXXX.......X
X..X....X...X.....XXXX..X..XX......XX......X...X......X.......XX..X..XXX...XX.XXX...XXX.XXXXX...X....
X..X.XX.X.........XXXXX...X...XX...XX.X......X...XXX....XX.XXX...XX...X....XX..XXX...X......X........
........X..XXXXXXXX...X.....X....XXX..XXX.......XX...X...X..X.......X...X..X...X...X...X.XX......X...
.XXXX....XXX..XXX...X....XX..XX..X...XXXX...X....X..X..X..X...X...........X..X........X..XX........X.
.....XXX.XX...XXX...XXXX.........X..XXX...X....X.XX...XXX.X..XX..XXX...X..X.X..XX.XXX...XXX...XXX....
X....XX..X..X.X.......XXXX.....X..X...X......X...X...XX...X..XXXXXX..X....X...XXX..XX..XXXXXX..X....X
X...X...XX.XX....X.....XX....X.XX........X....X....X..X..XX.......X.....X....X...X..X........X...XX..
XX..X......X...X.X...X....X....X.....X...X....X.X..XX..X.X..XX........X....X...X....X..X...X......X..
...X..XXX....X.....X....X.....XX.......XX..XXXX.X..X...X...X...X...XX...XX....XX.....X...X..X..XX....
..XX....XXX.........X......XX...X..XX...X...XXX..XX..XXXX........X.....X....XXXX.XXX.X....X.XXXX...X.
X....X..XX...XX...X.X...XX...XX.X.....X..XX.X..X.XX.....X..XX........X.X......X......X..X......X...X.
.......XXX.X..X...X.X.X...XX......X....X..X....X....XXX.XX....X.............X...X.....X....X...X..XX.
.X....XXXX.XX.XXX.X...XXX.XX...X.....X..X......X..X.XXX..X..X.X.......XXXX.....X......X..XXX.XXX.....
.X.XX....X.....XX..X...X.....X...X.X....X................X..X...XXXX.......X.X...X..XXXXX....X...XXXX
...X...X..XX.X...X.X.X.X.X.XXXXX.X....X....X.......XXXX...........XX....X....XXX....XXX.....X..X.....
..X..X..X....X...X...X.....X...X....X....X...X..XXX...X........XX..XXXX...X.......X...X.....X.....XX.
X...X...X..XXX...XXXX...X....X....X.XX...XX.....X...X.XX..X....XXX...XX.........X...X...........X....
....X......X......X...XX..X...X.......XX....X...X..XX.X...X...XX.....XX....XXXXXXX.....X.........XX..
.X..XXXX........X...X....X..X.X....XX....X....X..X..X...X..X.....X..X....X.....XXX.X.X...XXXXXXX.....
..XXXXX..XX.....X.......XX......XX.....X...X.....XX.XX..XX.X.X.XX...X..X.....X.XXX...X......XXXXXX...
X....XX...X.....X..X.XX....XXX......XX....X..X.............X...X..X..X....X....X..........X......X...
XX......X.XXX....X.X.....X.X......X.....XXX.X..XXXXX.....XXX..XX.XXX........X...........X............
..............XX...XXX.X.....XXXX....X...X..X..XXX....XX..XXX....X....XXXX....X...X...XXX..X....X....
.XX..XXX.X....XXX..XXX.X.XX....X.....X.X...XX......X......X.....XX.XX...XX......X...X..XXX...XX......
..XXXXXX.X...XXXX..XXX.X.....X...X.X...XX.....XX.....X.XX....XX.XX..XX.....X........XX..XX..X....XXXX
X....XXX.X...........X....XX..X..X.......XX....X....XX.....X....X...X..X.X...XXX......X.............X
X..X.X...X............X...XXX.X.....X.....XXXX.X..X.X....X....XXX.XXX.XX..XX....XX.....XX....X....X..
X..X...XXX..........X.....XXX.....X.....X......X..X...XXXX..X.....XXX.....XX..X......X....XX...XX....
