79 79
..XXXXX........XXXX..X.......X...XX...XXXX..XXXXX..XXX....XXX....X..XXXX..X....
.....X..X...XX....X....X.......X....X....X.....XX...XX.X..XXX....X.....X....XX.
...X...XX.X..X....X.XX.....XX.....XXXX...X...X....X....X.XXXX...XX.X...X.XX....
...XX.....XX.....XX........XX...X...XX..X..XXX.......X......X.X..X.X.XXX.X..X..
......XX..XXX....X....X.....X.X..XX..XX...XXXX...X.X....X.....XX...X.....X.XX..
XXXX...XXXXX..X....XX.X...X...XX.....X.....XXXX..X.............XXXXXX..........
..XX.X.....X....X.....X....X......XXXX...X....X.X...X....X..XX..........X...XX.
...X....XX...XXXX.XX.....X...XX...XXXXX.....X.X...X...X....X...X....XX...XX..X.
.X....X...X..XXXX..X...X..X..X..X..X....X.X...X..XX.....X....X...X..XX.X...X...
....X...X....XXXXX...X..X.X..X.X...X..XX..XXX.....X..XX...X.....XX.XX..XXX....X
X...X........XXXXXXX....X.X..X...X.XX..X......XXX.X..X......X....X....XXXX..X..
..X......XXXXX...XX...........X..X...X.......XXXX......X.XX......XX....XXX..XX.
.....X...XXXXX.X.XX.XXXX...XX.XXXXXX....XXXX...XXXXXX..X.....XXXXX..XX.XXXX....
XX.X...X.......X.X.......XX...X.........XXXX.....X.....X...X.......XX..X....XXX
...X..........XX...X............X...XX.............XXX.X.X.X....X..X..XX.X.....
.XXX..XXX...X.X..........X...XX...X....X....X...X......X.....X..X....X...X.XX..
..XXXXX...X.....X...X....X...X....XXXXXX.X..X.....X...X...XXXX.XXXX....XXX.XX.X
X.X.........XX....X.....XXXX...X....XX...X.X....XX..X...XX..XX......X..XX..X..X
..X..X...XX...XXXXXX.XX.XXX......X...X.......X.....XX.......XXXXX.....XXX....XX
...X...X......X....X....XXX........X..XXX......X....X.XXXXX...X...XX..XXXX..XXX
XX........XX....XX.X...XXXX.....X.XXX..X....X.....X...........X...XX....XX.....
..X...XX.....X.......X....X.X...X..XXX...X..X...X....X.....XX........XX....X...
....X....X.....X..X.....X.X....XXX....XXXX.XX...X..X...XXX....XX......XX.....XX
......X..XXXX..X....X.XX.....X.XX...X..XXX.XX...X..........X........X....XX....
XXXX...XXXXX.....XX...XX.X.....XX.X....XXX.XX.....X.....XX...X...XX...X..X..XX.
XX...X....X..XX...X......XXXX...X....X.........X..XXX...XXX....X..X......X...X.
XX......X.X.....X...XX..XXXX..X....X......X.XX......XXX.....XXXXX....XXX.....X.
...XX.XXX........X..XX...XX..XX..XXX..X.X...X...XXX...XXXX.......X....XX..X....
...XX..XXX....XX.......X..X...X....XX.X....XX.X............XXXX.....X.....X.X..
..X....XXX..X.XX........X..XX....X....XX.X........XX...XX...X...X.......XXX.X..
....X...XXX.X..X.XXXXXX.XX.....X.XXXXX...X.X...X..XX.X....X...XXXXXX...........
.X......X...XX.....XXXX............XX..X.....XX..XXX...X...X.....XXX......XX.X.
...X.X..........X....XX..XXXXXX.......XX.XX...X.XXX...X..X..XX.X.XXX.XX...XX.X.
X....X...X........XX..X.......XXX..........XX.......X...XXX....X.....X....XX.X.
..X......XXX...X.XXXX...XX......X.......XX....XX.......XXXXX....X......X..XX...
......X..XX..X.X..XXXXXXX..X......XX.....X..X......X....XXXX.XX...XXX....XX....
.XX...X.....XX....X...X...X........X.XXX.X..X..XXX......XXXX.....XXXX.X.....XX.
.....XX......X..X...X....XX.....XX...X...XXXX..X....XXX..X....XX.X..X...X.X....
XX.X...XXXXX....X....X.X.....X......X..X..XX.....XX..XX.....XXX..X......X...X..
X..XX..X......XX...X.X....X....XX...X.....XX.XX....X......X.....X..XXXX....X...
X...X.X..XX......X...X..X...X.X.....XXX...X.....X.....XX......XXX.....XX...X...
..X.....XX......XXX..X...X..X...XX..X...X.X.X.XXX.X.X....X....X.......XX...XXXX
.....X.....X.XX....XXX.X.X...X.....XX.X.X.....XXX.X....X.....X..XXXX..XX.......
.......XXXXX..X..X.....X...X.X...X..X......X.........XXX..X....XX.....X...XX...
XXXXX....X....XX....XXXX..X....XXXX....X.....X...X.XXXXX..X.X......XX...X.X....
XX....XX...XXXXX.XX....X..X.X........XXX..X....X.X..XXXX..X......X.....XX.X.X..
...XX.......XXXX...XXX..XXX..XX....X..XXX...XXXX....X.....XX.....XX..X..X......
....X..XXXX..XXXXX.XXXX.XXXX....XX..X......X..XX........X......X.XX..XX....X...
XXX..X.......XX..X....X...XX..XXXXX.XX...X....XX.....XX.....X....X...X...X.....
.....XX....XXX...XXXX.....X....X.......X...XX..XX...XX...XX...X....X.X.X....X..
.XX...X..X.....X..XXXXXXX...XX...X.X..XX.......X..X....X..X..X....XX......XXX.X
..X...XX....XXXXX....XX...XXXX..XX....XX.........XXXX..XX..X...X......XXX.....X
X.XX..X...X.XX.......X...........XXXX.........X...XX...X...XX....X.....XX...XXX
X.....X.X......XXXXXX..X...X...X.X....X...X.....X.XX...X....X........X.........
....X...XX...X....X...X..X...X.....X....X....X........XX..X.XX.........X.....X.
.XX.....X..X...XX...XXX......XX.XX...X.....X.....X....X...X.XX.....XX....X.X...
.XX..XX...XX...X......XXX....XX......X...XXXXXXXXX.X..XXX.X........XX.X..X....X
.XX..XX........X......XX..X..XXXX......XXX...X..XX...XXX....X......XX.X.X...X..
...X..X..XX....X.....XXX......XX....X......X....XXXX...X.X....X.....X.....XXXX.
XX....XX....X....XXX.XXX...XX....X....XXXXXXX...X....X...X.X......X....X...X...
X.....XXX.....X........X....X..XXX.X.......X....X......XX..X.X...........X....X
X.XXX...X..X......X......XX.X..XXX.X.XXXX....X....X.XX....X.....XX....X.....X..
X.X...X.XX...XXX..X...XX....X..X...X......X....X....XXXX..X.X.X.XX....X...X..X.
X.....X........X.XX.X..X..XXX..X..X......XXXX...XX........X.X....X......X....X.
...X....XXXXXX......X..X...XX...X...XXX..XX...X.....XXX...X....X.X...XX....X...
.X...XX......XX...XX...X...XX.X.XX..XXX.XX..XX...XX...X...XXXXXX...XXXXX...XX..
....XXX..XXX.XX.X....X.X......X.....X....X.....X...X....X..XXXXXX....X....XXXXX
X....XXX........X.X....X...X......X....X.XXXX..XXX.X.X.....XX..XX.XX....X......
.....XX..XX...X...XXX...XX.X.X.........X....X..XXX.....XX......XX..XXXX........
........XXX...........X.X....X.X...XXXXX.......XX...X........X..XX...XXX......X
XXXXXX...X.......X......X.X....XXX...X.....X...XX........X...XX.......XX...XX.X
...XX..X.X...........X.XX.XXX..XXXXX....X.....X....X.XX..X.XXXXXXXX.X....X....X
.X..X.XX.XXXXXXXX.X..X..X.XX..XX....X.X.X...X...XX.X.....X.XXXX..X..XXX.....XXX
..X...XX.....XXX..X.XXX...XX...X....X.....XXXX.....XXX...X.XXXX..X.X....X.X.XXX
X..X....X..X.....X..XX..XXX..X.X...X...XXX..XX....XXX..X.........X.X.X..X.X..XX
XX.X.XX....X..X....XXX..XXX.XX...X...X......XXX.....X.....X......X...X..X..X...
XX.......X..XXX.X.........X..X..XX........X..XX.XX....XXX.....X......X..XX..XX.
....XX......XXX.X.X....XX....X...X.XX.X......X.....XXX.....X..X...X..X......X..
.......XX.......X...XX.........X...XX...XX.....X.......XXX...XX.....XXXX......X
