95 95
..X....XXXX..X.....X..X.....X....XXX..X.....X.........XXXXX..X.....X....X....XX......X.........
....XX....X....X...X....XXX.X.XX.XXX....XX....X...X...XX..X....XXX...XX...XX....XXXX.X.XXX..X..
.XXX....X.X...XX.XX..XXX....X..X...X...X...X....X...XXXX....X...XXX....X......XX...X...X....X.X
.....XX.....XXXX....XX.....X...X.....XXX.....X..XXXX...X...X..X.XXX.XX......X....X.X......X....
....XX...XX...XX..X.....X....XXX..XX.........X.......X...X...XX.XXX.....X.....X..X......X.XX.X.
.XX..X......X.X.....X.X...XX..XX..XX....X......XXX...X......X...X....XX....X........X...X.XX...
..XX......XXX...XX..X....X....XXXXXXX.....X...X....X......X.X.XXX.XX.....X...XX...XXX.X........
X..XX.....X......X..XX...X.XX..X......XX....X...X.....X..XX.X........X...XX..XX.X.XXX....X.XXX.
XX..........XXXX....XX.....X...X...XXXXX.......XXXX......XX....XXX.X...X.....X..X...XX...X.....
.....X........XX........X..X....XX......XXXX.X.......XXX.XXXXX.....XXX.......X.X..X..X.XXX..X..
.XXXX..X..XXX.XX...X.X..X.....X..X..X.....X..XX......XX..X...XXX...X....X....X.X..XX...XXX...XX
.XX...X..XXX..XX.....X.XX.....XX....X.......XXX...X..XX....X..XX.X...XX....X...X......XXXX.X...
.X....X...XX.XXX..X..........XX...XX.....XX..XX....XX...XXXXX.X..........X.XX....XXX.......XXX.
...X....X....XXX..X.X...XX...X..X....X.......XX..X..X.X....X..X.X.X...XXXX.XXXX......X.........
X....X...XX...XXX.....X........XX.X..X..XX...XXXXXX...XX...X......X.X......XXX..XXX..X....XXX..
X...XX.X..X.X......XX...X.....XXX...XXXX...X...XXXXX.........XXX....X....XXXXX....X..X.X....XXX
XXX..X.XX.....XXXX..X.....X.XXXXXX..XXX..X.....XXX......X..........XX.X..X.....XX.X....X.X.....
..XX......XX....XXX.X..X..X........XXXX.....XX........X.X.....X.......X.X..X...XX.X........X...
......X......XX...X..XXX.XX.....X....X....X..X..X.....X...X.XXX...X.X.....X..X....X.....X..X..X
...X....XX...........X......XXX.X....X.XX....XX...X.XXXXX...X.......X....X..X...XXX.XXX....XX..
.....X......XX...X........XXX..........XX..X...XX.X..............XX....X...X..X.....XXX.XX.XXX.
XXX......XX....X......X...XXX.XX.X..X....X.XXX..X...XX...XXX.....XX.XX.....X.....XX........XX..
..XXX....XX..XXX..XX....XX....X..XXXX..X...XX...X......X.X.....XX.....X........XX...XXXX....X.X
..X....X..X..XX...XX.X.....XXXX.....XX....XX..X......X.....XXXXX...X......X...X...XXX.....X...X
....X.....XXX...X.......X...X....XX.XXX...X..X.....XX.....XXX....X.X.X......X.........X.....XXX
...XX.X........X....X.X...X...X..X..X....XX.XX.X......X.X.....X..X...XXXXX...XXX...XXXX.XX.....
.XXXX......X.X.X.XX...XXX.......XX.....X..X......XXX..X......XX..XX..XXXXX.X....XX..XXX....X...
.XX..XX....X...X.....XX.......XX..XXXX..X...XXX....X.....XX..X...X...XXXXX.XX...XXX.XXXXX......
.....XX...X......X......XX.....X.....XX......X..XX.....X....XX...X.....XXX......XXX..X.....XX..
XXXX..XX....X.......XX.......X...X.......X.X...XXXXXXX...X......XX..X...X........X...X.X.X.....
XX..X....X.XX.X...X....X......X....XX....X....X...XXX..XX..XX...XX..X.X...XXXXXX...X...X....XX.
XX...X..XX......X........X....X....XX...X...XXX.X.X...XXX.....XXXX....X..XXXX...XXX..XX...X....
...X.X.......X....XXXXX....XXXXX......X...XXXX..X....................XXX......X.....X...X......
.XXX.X...X...XXX.....X..X....XX.....X....X.....X.....XXX.....X.....XXX...XXX..........X..X.....
.XXX...X....XX...X...X....XX.XX.X......X.....XXX......XX...X.....X.X....XXX..X.X...X.....X..X..
..........X..X......XX.....X....X....X...XX.........X...XX.XX.X..X....X..XX....X.X...X...XX.XXX
XXX.....X..X......X..X...X...X..X...........XX....X...X....XX...XXXXX..X....XX...XX....X....XXX
XXX........X..XXXXXX...XXXX.....XXXXX.....XXX..XX.......X..X...XXXX..X..........XX..X......XXXX
XXX....X.........XXXX...XXX.X.X....XX...X.....XXX..X.XX.X..X.X.X..X...........X..X....XX.......
..X...........XX.XX...X.XXX...XXXX....XXX.......X....XX...X..X.X....XXXXXX...XXX.X...X....X....
..X...XXX...X..X..X...X........X..XXXXXXXX........X....XX.X.XX.X.....X...X.X.X.....XXX..X....XX
....X.....X..X.XX...........XX.............X.....X..XX.XX.X..X.......X.X...X....X....XX.XX.X...
.........X...X.X.....X......X...X.........XXXX.X...XXX.......XXXX....X.XX..XX...X....X..X..XXX.
...X...X.X.XXX.X.XXX.....X....X...X..........X...........X....X....X...XXXXXX...XX...X.X..X....
.X...XXX.X..XX...XX...X..X...XX..X..X...XX...XX.....X..X...XX....X.XXXXXXXXX....X..X.....X..X..
..XXX..X....XX......X...XXXX.......XX.X.XX..XX....X....X......XX.............XX...XXXXX.X..X...
X...X..XXX..X..XXX.....XXXX....XX.....X..X.....X....XX......X...X.X....XX....XX...X..X..X.XX...
..X.........X.XX...XXX....X.XX....XXX..X...X.....X..X.....XXXX..X....X..X..X......X..X.....XXXX
..XXXX....X......X..XX..X...XX..X......XX..X.XXXXX..X......X...X...X.XX..X...X....X......X.....
....X..X..XXXX......XXX....X........XX..X..X..X.......XXXX.......XXX...X......XX....X.....XX...
.XX...X..XXXXXXXXXX..XX..X.......XX.XXX.X..XX...X.......XXXXX...XX.....XX...X...XX......X.....X
.X......XXXXXX....XX...X......XXX....XX....XXXX...........XX..XX..........X.XXX.XXXX........X..
.X.XXX....XXXX....X....XX...XXXX...X....XX..XXX..X.........X...X.XX...X...X...X....XXX.X....XX.
.....X...........XX.X.....X.X....X.XX...X...X..X...X.....X...X...X..XXX.......XXX....X.X..X....
X.XX.X...XX....X..X......XX.X.X....X....X......X...X...XX.......XX............XX..X....XX.XXX..
X......X.....X....XX.XX.....X...X....X.......X.......X....X...X....X...X....X....XX.....X.....X
....XX...X.X.XX......XX.X..............XXXX..XX...X....X....XXX..X...X.XXX......X.......XX....X
........XX...XX..X.X......XX..........X.....X...X....XXX.....XXX....XX..X..X......X......X.XXXX
..XXX.X.X.....XX.X....XX...XXX........X....X..X....X.XXXXXXX......X..XX...XX..XX.XX.XXXX.......
..XXX...X.XXX.......X....X..XX.........X.....XXXX.........X....XX....XXXXXXXX.XX..X...X...XX...
....XX........X...X....XXXX..X....XXXX...XX.XX....X.XX......XX...XXX....XXXXX.....XX..X....X.XX
.XX..X.X.X......X....XXX...X...X......X.....XX.X..X.XX.X................XXXXXXXXXXX..X..XX.....
..XX.....X.X.........X...X....X..X.XX.X..........X..X........XX.X....XXX......XX....XX..XXX.X..
X.....XXX....XXX.....X..X.......XX.XX...XXXXX......XX.X....X.XX...XX.......XX....X..XX......X.X
..XXX...X.X....X.....XX.X.XX.X...X.XXX..X.....X.....X..XXX.X...X........X........X..X..XXXX...X
......X...X.XX.XXX...XX.X..X...X.X..X..XX.XXX.....X.XX...X..X....XXX....X.X.X.......X....XX..XX
.X........X.XX.XX....XX.XX..........X.X...XXX..XX.X..X......X.X...XX..X...X.....X........XXX..X
.X...X.XX...XX..X.X.....X....XX...XXX...XX......X..X.X....X.....X.XXX....XXX.XX....X.X....XXX..
.X...X..X....XX.X.X.XX..X.X.....X..X.....X...XX..X...X..X.........X....X.X...XX......X..X..XXX.
.X......X.XX..X...X....X..X.X......X..XX.X.....X......XXX.XX...XX......X.X....X...X...X....X...
..........XXX.X....X...X.....XXX...XX....X........XXX........X....XX..........X.....X....X.....
..XXXXXX...XX...XX.......X.X...X...X...XXX....X.....X....X.......XXX....X...........XXXX.......
..X......X..........X......X.....X.X.X..XX..XXX..X..X.XX.XXXX.....XXXX....X...XX........X......
....XXXXX...XXXX......X..........X......XXXX.....X.XX...........X......XX...X.XX...X....XXX....
........X.X..XX....X.....XX.......XXX....X.....X...X....XXX..X..XX...X...X..X..X.....XXXXX..X..
XXXXXXX......XX.X....XX....XX...X.X....X.X........XX.........XXX...X...X....XX...XX......X.....
....XX...X........X.....X...X.XXX...X..X......XX..XX.......X.X....X...XXX...XX...X..X....X...X.
.......XXX.XXX.X.......X..X.X.XXXXXX..X...X.XX...XX..XXX...X....X...X.XXXXX........XX...X..X...
..XX.X.......X.....X.X...XX...X......X..X...XX......X........XX..XX........XX........X....XX...
...X......XX.XX.X..X....X....X......X..XX..X......XXX..XX........X...X........XXXXXX.X.X.......
.X....X...X..XX.X.XXX......X...X.X..X.XXXXX..XX...XXXX...XX........X....X...X.....X..X......X..
.X..XXX.X.X.X...X.X.....XX...XXX.X.XX.XXX...XX..XXX..........XXXX.....X.XXX..XXX....XXXX....XXX
..X.....X.....XXX...X.....X..X...X..X..........XX...X.....XX..XXXXX.....XXXX.....X...X...X..XXX
X......XXXXX...XXX.....X...XX..XXXX..X..XX.X...XX.....X...XXX...XXXXXXXXXXXX.........X.XXXXXXXX
XX.XX..X.......X...X.X...X.XX.....XX.X...X...X..........XXX..................X....X............
...X..XX...........X..X........XX......X...XXXXXXX..........XX...XX....XXX......XXX...X.X......
.....XXXXXXXXXXXX.....X.X...XX......X...XX..XXXXXXXX...XX..XX..X.......XXX.XX...XXXXX...X...XXX
XXX.....X....XX...X.....X.X..XX....XX.X...X.X......X.X.XX.....X..X.X...X......X....XXXX........
....X...X.XX..X.X.......X....XX..X.XX.....X...X......X....X..XX.XX...X....XX.......X.......X...
........X.XXX...X..X....XX...XXX.X.....XXXXXXXX.X.....X......X....X.......X..X.......X...X.....
XXXX....X.X....XX.....XXXXXX..XX.....X.....XXX..X..XX......X...X....X.X.....XXXXXXX....X.......
XX......X......XX...X....XX...XX..XX.....X.....XX..X...X.........X..X...XX..........X..........
...XX.....XX.X...XXX...X.X..X..XX..X..X........XX....X....X.XXX....XXX..XX.X......XXX.X........
.XXX...X.....X.X.XX..X.X...X...X...XX...X.XXXX.X..X.....X.X.XX..X..XX......X.XXXX..XX.XXXXX....
.....X...X.....X....XX.......X...X....XXX......X....XXX...X....XX..XX........XXXXX....XXXXXXX..
