100 102
..XX...XXXX......X.....XXXXX.......XXXXXX..XX....X..X......X....X..X..........X...XX..XX.....XXX......
.....X...XX......X.XXX.....X.X..........X...X.XX.X....X......X..X..X.XX..XXX....X.XX..XX.XXX.XXX......
..........X...X..X.XXX.......X....X.......X.X..X...X....X.X....XX....XX..XX..X.XX..X...X.......X..XXXX
XXXXX...X...X...X..X.....XX.XXX...X..XXX.XX....XX....X....X.XXXX..X......X..XX...X...X.X....X..X......
....X......XX.....XX.XX...X..X....X......XXXX.....X....X....XX...X....XX...X..XX....XX...X..X....X....
....XXXX.XXXX..X........X....X.X....XX....XXX....X..X..XX..XXX.XXX.X......XX....X.....X....X..X..X.X..
...X..XX.......X..X.XX.....X...........XX.XXX..X.X....XXX....X...X.X...XX.X..XX.XXXXX...X....X...X.XXX
.X.X...X...XXX..X.X..X..XX....X...XXX...X..XX..X.XX..XXXX........X...X....X...X..XXXXX....X....X...XXX
.....X...X....X...XX..X...X.X....XX...X.XX.XX.....X...XXX.....XXXX.....X....X.XX...XX....XX.X..XX..XXX
..X...X.....X.....X...X...X..X......X......XX...X...X.XXX......XXX....XX......X.......X.....X..X...XXX
......X.X.X....X..X..........X..X.XXX.XX....X...........X....X.XXX..X....X.X....X...X...XX.......X.XXX
...X....X....X.X.XX...XX...XXXX.X...X.X...X.....XXXX.XX.X.XX...XXXX..XX....X.XXX..X........X....XX....
......XX...X.X...XX.X..X.XXXXXX.....X.X.X....XX....X......XXXXX......X..X.XX.....XX.XX...X....X.......
XXX.X.XX.XXX..X.....XX...X...XX.......X..X.......X..XX.X....XXX....X...XX...X............XXXX..XX....X
..X....X..XXX.X...XXXX..X..X.......X..XX.X....XX..X.XX.X..X...X..X....X.....X......X.......XXX....X...
.....X.XX.X.....X..XXX....XXXX...X.X..X..XX.......X....XX.....X..XXXX...XX.....X...XX..XXX...X..X...X.
.XX.......X.XX.....X.....X.....X......X...X..X.....X....X..X...XX.................XXX..XX..X..X..X....
.X....X..........X.........X...X.XX.X.....XX.XXXXX...XX....X.X......XXXXX.X...X.X.XXX..XX..XX....X...X
...X.....X.X.....XX.....X..X.X.X....X........XXXX...X......X...XXX......X.....X.....X...X.....XX..XX..
X....X.....X..X....XX.XXX..X.X........XXXXX..XXXX.....XX...XX..XX..XX......X...X......X...XXX.X...XXX.
..X....XX...X.XXX...X.X....X...XX....XXXXXX..XXXX..X.....X....XXX......X.X...X.X...XX....X..X...XXXXX.
....X.....X.....X.X...X..X........X..X..XX..XXXXX....XX......X..XXXX.X...XXXXX.X.XXX..XX....XXXXXX....
XX....X......XX...X....X....X.......XX...X...XXXX.XX.X....XX.X.......XX.....XX...XX..XXXXXX..........X
X....XX.XX....X..XX.XX.X..X...XXXX.....X...X....X..X...XXXXX...XXX.......XX.XXXX....X...X..XX...X.X..X
X.....X...XXX.X...X....XXXX........XXX....XX..X..X....XX..X......X...X.X....XXX..X....X.X.....X.X...XX
...XX..XX.XXX.....X.....X......X.....X..X.....XX....X.....X....X.XX..X....X.....X.........X...........
.X.....XX....X.X....XXX.X.XX.....XXX..X.....X..X..X....XX.XX...X....X...X......XX.X....X....XX...XXXX.
.X..XXXXXXXX...X.X..XXX...XXXXX....XX....X.....XX....X..X........X....X......X.XX....X.XXX....XX....X.
.X...X........XX.XXXXX........X......X.XX..XXX..X.XX..X.....X......X.XX..XX....X...........X.....XX...
...X...X....X..X.......XXX........X..X....XXXXX...X...XXX.......XX.X..X..XX.X..X....X.X...X..X.X.....X
X..XX....XX.XX.XX......XXX...X......X.......XX...XX.X.....XX.X...X....X.....XXXXX..XX.X.X...XX....X..X
X..XX...XXX..X..X...XX....XX.XXXXX....XXXX..X..X....X.....XX.....X..XXX..X...XXXX.....X...XX....X...XX
....X.X...XX.XX.XXX.X.....XX...XX..X...X...XX...X....X....X...X.....XXXX...X..XXX...XXXXX....X........
.XX...X.X.......X.....XX...XXX....XX.X.....X....X.XX...X..X.X...XXX...XXXXXXX...X....XXX...X...X...XX.
..XX....XXXXX......X.....X...X.........XX....XX...XXX..X..X.....XX....X..............X...X.......X....
X.X..X..X........X.....XX....X.XXXX.X.....X.X........XX....X....X..X.........X...X...X........X.......
X.X.XX..X.X...............XX.....X..X.X.X...X..X.X......X.......X.X..XXX...X...X...X.........X..X.....
X.X.XX..X......XX.....X....X..X....XX...X....X.X.X..X.X...X.XXX.X...XX...XXXX........XX....X...X...XXX
X.......XX.X...XX...X....X..X.X.XX..XX.......X.X.XX.X.....X.....XX..XX.X......X.........X.....X..X....
...X....X..X...XXXX....X....X...X...X..X.X...X.X................XX..XX.......XXXX.....X...XXX...XXX...
.....X....X......X...XXX..XXX..X..X...X..X.X...X...X.......X....X..XX...X.X..X...XX......XXXXXXXX....X
XXX....X....X......X...X....X....XXX..X....XX..X.X....XX.......XX..XX.X...X.XX.X.......XXX.........X.X
...XX.......X.....XX.X.X..X.X...X.....XXX.....X..XX...X...X.....X.....X..XX....X..XXX...XX....XXXX...X
...X..XX........XXX..X..X.X..X..X.....XXXXX.X.X......X..X...X.X.X......X..XX...X..X...X..X..X.....XXXX
..X..XXX...X....XXX.XXX....X...XX....XXXXX..X..XXX.X.X.XXXX.X.......X.....XX.X.XXX....XX.......XX.....
....XX........X.....XX...X.X..XX..X..X..XX...X.....X...XXX..XX.XX.........X....X...X..XXX....XXXXX....
.XX.........X...X..XXX.....X..X..XX.XX.....X....X..........XX..X...X.XXXXXX.X....XX....X..X...........
..X.X.......X...X.......X..X....XXX.XX.XX..XX.X...X..XX...X...X..X.....XXXX....XX...X..X........X.X...
X.....X...........X..XX...XX...XX......X..X...X.XX..XXX.X...XXX.X.......X....X....X...X....XX...X.....
...X....XXXX...XX....XX......XXX.....XXX.X..XXX..X....X.X....XX.X.XX.......X....X.......XXX....XXXXX..
.....X...XXX...X..XX..........X..X....XX.X...XXX...XX...X....X....XX.XXX.X..X.....XX.X.......X.......X
..XXX..X.....X...XXXXX..XXXXX...XXXXX..X...X...XX....XX..X.....X.........XX....X..XX.......X..X.......
..XX..XX..XX.......XXXXXXXX....XXX..XX.X.......XX.XX.....X.XX.......X.X....X...X..X...X....XX.......X.
.....XXXXX...XX.........X...XX...X...X.X...............X...X..XXXX....X..X....X..XX.....X....X.XX...X.
......XX.....XX...XX......XX.......X.X.X.....XXX.X.........X...XX..X...X....X.X..X.....X..XX.X....X...
XXXXX....XX..XX...XX...X...X..X........XX......X.....XX....XXX....XXXX....X...X....XX....X........XX..
XXXX..X..X...XX.....XX...X..X.....X.....X...X.............XXX..X.....XXXX.......X.....X.....X.........
...X..X..X.X....XXX.........X..XX....XX.XX....XXXX..X.....XXX....X...XXX.......XX....XXXX.X.XX...X....
...X...XXX..X.....X...X............X..X....X....XXXXX....XXX..XXXX.XXXXX.X.....XX..X...XX...X..X.....X
..X..X.XX...X.XX....X.....XX.....X..X.XXX.....X.....XX.....X...XXX.X...X...X.X.....X.......X..XXXXXX..
....X.....XX..XX.X...XX...XX........X.XX..XXX.......XX.XX...XX..XX...X.....X.X..XX.X....XX...X....XXX.
...XX.X......XX..X.X..X..X..........X.XX.XXXX..XX....X.X..X.....X.....XX.....XX....X..X...X....XX.X...
.XXXX....XX.....X.....XX.X.X........X....X........XX.X.X.....X....XXX.....X...XX........X...X..X..X...
..X....X.XX.XXXXX.X........X......X..X.........X..XX.......XXX.X..XX....X...X.XX.XX....XXX.....X.X....
X......X..X...X...XXXXX.XX....X......X.XX.XX..........XX...XX.....X..XXXXXX.X..X...XX....XXX...X...X..
XX.....XX.XXX......XXXX..........X.....X..XX.XX....XXXXX.X....X.X...X....XX....XXX....XX......X...XX..
.....XXXX....X...X...X.........X.XXXX..X.....XXXXX....X..XXX..X.X..XX..X.X...X..XXX....XXX....X.X.X..X
........XX.....X.X.....XXXXXXXXX.XXXX..XXXX..XXXXXXXX...XXX...X....XXX.X...X....X...XX..XX.X....X.X...
.....XX.X........X....X...XX.....XXX..XXXX....XXXXX..X....X......X.........XX...X.XXXXX......X......X.
.XXX.XX...X.............X........XXX....X..XX....XX............X......X.......X......XXXX......X.XX...
...............XX.........X.X....XXX......X....X..X...X....X....XX......X...X......X.....XX......X....
X...X......XX..X..X.XXX.....X.X..XXX...XXXX....XX...XXX..XXX.XX......X....X..XXXXXXXX.....X...XXXX.X..
..X....XXX.XX.XX....XXX..X.XX....XX..XXXXX......XX.......X...X....X..X.XX.XX..X.......X.X...X..XXX....
.XXX...XXX..X....XX....X.X.....X....XX.....X..X.XX.XXXXX....X..X....XX........X...XX....X..X...XXX..X.
.XXX......X....XX..............X..XXXX..X..XXXX....XX...X.X.X....X..X......X...X..X..X...X...X......X.
......XXX....X.....XX...X......XX..XXXX...XXXX......X.X.X.......X...X......X.X...XX......X........X...
X...X......X.......X........XX.....X......X....X....X.X...XX.XX...X.....XX...XXXXXX...XXX...XX....XX..
..X.....XX.XXXX....X.X.X.......X...X..XX....X....X....XXX.XX...X.....XX.......X.....XX....X..X.X..XXXX
.XX..XX.XX...XX..X.X.X....XX.X...X.XX.XX........XXXX...XX....X...XXX..X..XXXX...X...XX.X..XX..........
..XX......XX...X.X......X.XX..XX.X...........X..XX...X.....X.....XXXX.......XX....X....X..X..XX.XX....
X......X.....X......X.X.....X..X.....XXXXXXX...XX..X..XX....X....X..XX......XX.X..XXX....XX.....X..X..
XXX.X..X...X.XX...X.X....XX....X..X...X......XXXX.XXX.X...X.....XX.....XXXX......XXXX.......XX....X...
XXX.X.X..X......X...XXXX..XXXX......X...XXX.....X.......X....XX.XX............X.....X.....XX.....XX...
..X.X.X.....X.XXX.XXX..XX...XX.XXX........X...X......X.....XXXX.X....XXXXX......X.......XXX...X..X...X
....X.....X...X.....X.....X.......XX.XXX....XXX........X....X...X.XX..X......X.....X.....XX.X...XX...X
.X.....X............X...X.....X....X.....X...XX..X....X...X.....X...X...XXXX...X.X....XX........XX..XX
.X.X.X.....XX..X......XXXXXX.....X...XXXXXXX..XX...X....X..X........X..XX......X.XX.....XX...XX..X....
.....X..X...X....X.....X..XX...X..XX.....X....XXX....X.XXX.XXX...XX..X....X....X.....X...XXX...X.X.X..
XXX.XXX...X...XX.XXXXX....XXX.....XXXX...X.XX.......XX.....XXX...X...X.X..XXX..XXX.X...X....XX.....X.X
X...X....XXX...X.XXXX..XX..X..X.XX.......X.......X...X...XXXXXXX...X...XXXXX....XX....XXX...X...XXXX..
X.XX...X.....X...XXXX...XX...XX.....X........X...X.X.X.X.X......X..XX..X...X.XX.....X.....XXX....XXXX.
X.X..X.........XXXXXX.X.XXX.......X.XXX........XX..X...X...XX.....XXXXXX.X.X.X........XX.........X....
..X.X...X...........X.......X.X...........XXX.....XX..XXX......XX.XXX..X.....X.......XXX...X.....X....
....X.X...X.....XXX....XXX....X....X....X..X..XXX..XXXX...XX...XX.XXX.....XXXXXXX....XX..XXX...X.XX...
XX..X.....XXX....XXX.......X...X...X..X..X...X.....XX.....XXXX..X...X......X..XXX...XXX...XXX..X......
...X...........X..XX...........X.X..X.XX.XX....X...X.........XX..........X....XXXX..XX..X.X...X..X....
.X...XXXXX...X....XXX.......X....XX...XX....XXX..X...X...X.......X.XX.......X.X....XXX....X..XX.......
.X......XX.X.XX...XXX...X...X.X......XX..X.............X......X..X..X...X.X.X.....XX...X...X.X..XX....
.X......X....X..X..XXX....XXX.X.XXX..XX....XX.....XXXX.XX...X...X...XXX...X....XX.X..XXX.X...X.XXX.X..
..........X....XXX.....X......X.....XXX.......X........XXXX...XXX.................X......XX..X.....X..
