8 10
XXX.......
X...X.....
X.........
X....XX...
X....X....
X......X..
..X.......
..........
