95 97
.............X..XX..X.....X.............XXXXX...X...XXXX......X......X..X...XX...X..X............
..XXX...X..X....X...X..XX....XXXX...XXX.XXXX..X...X.XX....XXX.X....X....X.X....X....X....X....XX.
X.X...X.X....XX...X..X.....X..XX..X...X.X....XXX....X...X...X..XXX..XXX...XXX..XXXX.XX.....XX.XX.
....XXX.X........XXX....X...X....XXX....X.X..XX..X....X........XXXX....X...XX..XXX..XX..X........
.X.X....X...X....XXXXXX...X....XXXX..X.......XX...XX.....X.XXXXXX..X.....X.....XXX...XX......X...
...X..XX..X.....XX...........XXX....XXXX...X....X....X...X...XX....X..X.XXX......XXX.XXX....X..X.
XXXXX....XX..X.....X...XX.....XX.X.......X....X....XXX.....X.....X..X...XXX...X...X..X...XX...XX.
.......XXXXX...XXXX..X..X..XX......X...X....X....X..XX..XX.....X.XX....XX.......X...XX.XX..X..XX.
.....X...XXXX...XXX.X...XX....XXX....X....X....X....X...X...XX...X..XX....XX.....XXXXX..X....X...
X....XXX......X.......X.....X.XX....XXX......X...XX...X...X.....XX.......XXXXXXX..XXXXX...XX...XX
X..XX..X...XXX.....X....X........XX.XX....XX...........X....X.X....X.....XXXX..XX.XXX....XXX..X..
XX.XX....X.....XXX...X..X....X..X...XX....XXX...XXXXXX.XXX..X....X.........XX.....X....XXXX...X..
XX..X...XX..X..XX.........X.....X...XX...XXXXXX...XXX..XXX.....XX...X.........X.....XX......X....
XXX...X..XX....X..X.........XXX.....X..X......XXX.....X....XXXX...X...X.....X...XX...XX....X.....
...XX....XX..X...XXXX...........XX....XXXXX.........XXX......XX...XX....X......X...X....X..X.....
.X....XX.XXX...XXXXXX......X......XX...X................XXXX......XX.X....XX.X...X....X...X...XX.
...X..XX....XX......X..XXX.....X.....X.....X....XX...XX.....X..X.....X.X...X....XX..XXX.XX..X....
X.........X.....X...X.....X.X....XXX....X....X...X.......XX.X....X.....X.X....X.X...XX..X..XX..XX
..X...............XX..X.....X.X.....X.....XX...X...X...X.XX...XX.........XXX..X...X....XX.......X
.XXXXX..XX.....X...X....XX......XXX.X..X....X...XX.X.X...X...XXX..X...XXX....XXX....X..X....XXX..
.....X.......XXX.X.X...XXX...X...XX..X....X...X..X.X.X.....X....X...X...X..XXXX..X.....X.X..X....
.......X.......X.....X...X.X.X.X...X..X..........X...X.XX..XXXX.X.XXXXX..X....X....X...X.X.XX.XXX
...XX.XX..X.......XXX......X...XX..XX...XX..........XX.XX...XX..X........XXX....X....XXX......X..
......XXX...X.XX......X.....XX....X..X....XXXXXXX....X....X....XXXX......XXX.X....X..XX...XXX....
.......XX.....XX.........XX....X..X....XX....XXXXXXX.X..XXXX..XXX......X.........XX.....XX....XX.
.......X........XX...XX..X..X.......XX.....X....XXXX.X...X....XXX..X...X...XX.XX.XXXX......X..X..
..XXXXXX.X......X..X....XX....X..........X.X..X..XXX.X.X....X......X..XX.X....XX.XXX.....XX...X.X
..X...XX...XXXX...X....X...XXXX.......X....X..XX...X......X.....XX.XX..X.X..X....XXX.XX..X..X...X
..X.X.XX..XX........XX...X...X...XXX....X......X........XXXX....X..XXX.X..X.....XX...XX.XX.....XX
....X..X..XX...X.....X..X..X...X..XX.XXXXXX..X....X........X..XXX...X.....X.XX...X...........XX..
.X.....XXXXXX..XXXXX.X..X.XXXXXXX.........X.....X....XXXXX.XX.....X...X......X.X.XXXXX...........
.....XXXX.....XXX....XX...X.......X.........XXX....X.....X..X..X..XX.......X...X..........XXXX...
..XXX........XXX..X...X..XX.X.......X...XX.XX....X..X.......XXX..XXX.X...XXXX..XX.......X.....XX.
....X.XXXX.X.XXX....X..X.X..X..X......X..X.....X....X.X.XX......X....X...X.....XX...XXX.X........
.XX........X.XX....X...X...XXX.XXX.....X....XX....X...X....X...XX.....X..X...X.X....XXX.....XX.XX
.X...XX.........XX...X...........X...X.XX......XX....XXXX....X....XXX....XX..X...X.......X..XX..X
...XXXX.XXX.X.....XXXX....X...X....X...X.....X.....X......X.....X...XX...X..X...X..XXX...X....X..
..XXXX......X.....X.....X...X...XXXXX....X...XX...XXXX..X...X..........X...X..X...X....XXX.XX.XX.
XXX....X.XXXXXX...X...X.XXXX...XX.....X..X.X......X.....X.XXXXXX...........X.XX.....X....X..X.XX.
X...XXXX.....XX.X.XXX.X......X.....X..X..X...X.X..X.XXX.X....X........X.XX.X..X...XX..XX..X...X..
....XX.....X....X.....XXXXX......X.X..XXX...XX.X..X.....XX...X..........XX....XXX.XX.XXXX..X....X
.X..X..X...XXX....XXXXX..X..............X.X..X....XXXX..X...................XX.......XX..X.X...XX
...XX....XXXX..XX.X........X......X.....X..X...XX.XX....X.X...XXXXXX......X......X.......X...X...
XX.X..X.....X...X...X.....XXXX.............XX.....X..XX.....X.....X..XXXXX..X.X.....XX...X.....X.
...X....X.......XX....X.X...XX.....X...X......X.X...XXXX........X.X.X...XX.X..X.X.X....X...XX..X.
.XX..XX...XX.X...X.X..X.X.X.XXXXX..X.XXX...X..X..........X...X....X...X....X......X..X......XXXX.
.XX......XX..X.X...X....X.X.X.....XX.XXXXX.X.......X.....X...X.X...XXX..XXX...XX........XXX......
.......X.XX....XX..XXX....X...XX.....X.......X..........XX.........X....XX..X.........XXXXXX.....
XXXXXX....XXXXXXX......X.......X...XX....XX.....XXX.XX..X..XX...XX...XX.XX.XX..XXXXXX..XX....XX..
........X.........X........XXX...X..X.X.....X.....X....XX...X.XXX....XX.X......X...XX..X..XXXXXXX
....X...XXXXXXX..XX...X.....XXX..XX.....X.....XX.......X..X.X..X..X..X..X.X.XX...X.....X.XX......
......X.....XXX..XXX.....XX.XX..XX...X....XX..X..XXXX..X.....X...XX..X....X........X...X....X....
...X.....XX.X....X...X.X.XX....XXX.....X.....XX.......XXXX.X.....XX......X....XXXX...X.XXXX...X..
.....X...XX...XX.....X....XXX......X..XX.XX....X.....XXXX..XXX......X......XX..XXXX..X.XXX....X..
..XXX............XX.....X.XX..XX...X...X.X..X....XXX......X....XX.X.....X.X....X....X..X...X..XXX
X.....X...XX...X....X........X....X..X.X...X..X.......XX....X.....X..XX.X.X.X....X..X......XXXXXX
X.XX....X....X.XX........XX.....X.X....XX..X.XX.....X......XXXX......X..X.X.....XX..XXX.....XX...
..X..XX...X..X..X.XX..........X.....X.....XX.XXXX.......XX.........X...X.....X..XX..XX....X..X.X.
.XX...X...XXX...X.....XXXX.X....XX....X......X............XX...........X.X.....XX....X.XXXXX...X.
......X.....X....XX...XXXX...X.....X....XX.XX..XXX..XXXXX..X...XX........XXXX.....XX.X.XXXXX..XX.
......X..........X..........XX.......X.....XX.XX...XX..X...X....XXX...X...X..XX........X....XXXX.
....X......XXXX....X.............XX..X.XX.....X..X.XX....XXX..X.....X.XXX.X..XXXXXX...XX....XXXX.
..X.XXXX.....X..X....X...X.......XX..X....XX....XX..X.....XXXXX..XXXX.XXX......XX...X..XX...XXX..
..X...X...XX...X..X....X..XX....X....XXX..X..XXXXXX..XXXX.X..XXXX.....XX..........X....X..X.X...X
..XX....X.XXX..X....XXXXX....X....XX..X...X.XXXX..XX...XX....XX.....XXX..XXXX...X....X...XX.....X
..XX.X.....XX....XXX.......XXX.X.XXXX...X.X....X.........XXX.....XX...X.X...X......X.XX......X...
...X.....X....X..XXX...XXX...X.X..XXX.....XXXX......X.XX..X...XX..XX..X...X.XXXXXX...X..XXX....X.
.X.X..XX..X......XXX.........X....X...XX..XX......X...XXX...X.....XX.X.........X.......X....X....
...X......X..X...X....X.................XX...XXXXXX..XXXX..XX..XXXXX.X.....X...X.X.........XXXX..
..........XX.XXX....X.........X....X.....X.....XXXX....XXXXXXXX....X.....X.X..X..X.....XX..XX..XX
....XXXXXX.....XXXX......X..X...X....X.X.XXXXX.XXXXXX...XXXXXX..XX.....X.X.X....XXX....XX...X....
X....XXX....X..X.......X....XXXXX.X....X.XX....X...X..X......X......XX.X.....X...XX.X..X..X...X..
X.XX......X.X....X........X...XXX...XXXX..X.X....X.X...X.......XX.XXXX...XX....X.XX.X....XXXX...X
X.XX...XX.....XX......X.X...X......XXXXXX...X.X..X..XX....X.......XX.......XX..X..X.X.X........XX
X.XX.X.XXXXX...X....X.X.........XX...X........XXX...XXX.X.XXX...X.......XX.XX..XX...X........X...
..XX.X......XX....X...XX.....XX.X....X.X..XX..X...XX..X...XX..X.....X.X..X..X....X..XX.XX....XX..
.XXX..X.....X..XX...XXXXXX...XX...XX.....XX...X.X..X...X...X.....X..X....XX.X.......X..XX....X..X
.XX...X....XX..........X...X...X...X..X...X.X.X....X.X...X...XXX...XXXXX..X...X.XX....X......X.XX
....XXXXX.....XXXXX..X.X.....X...X..X...X...X......X..X.........X..XX.....X.....XX.X....XX...X...
..XXXXXX..X.......XX.......XX..XX...X....XX....XXXXXX.....X...X.....X........X.......X..XX...XX..
XXXX.....XX....XX.X........XX...X.X...XX.....X...XXX...XX.X...X..X.....XXX........X........X....X
.....XX...X....XX...X....XX...X.X....XX..X...X.X..X..X..X...X....X.X.X......X...X...XXXX...XXX...
..X.....X.X...XX...XXXX..XX.XXX....X.XX....X......X.....X......X.....X........X..XX..XXX...X...X.
X.XXX.......X....X....X...X..XX.........XX......XX...XX.X....X....XX.......X.....X...X.....X.X...
..X..XXX.......X....X...X.XX..X.....XX......XXX....X.XX.XX......XXX.....XX...XXX...X...XX..X.....
.XX....X.....X....XXX..XX.....XXXXXXXX....X...X...XX..X..X.XX.....X.X.X.......X....XX.........X..
.X..XX..XX.X...XX.......X......X..XXXX..X.XXX.XX..X...XX...XXXXXX...X.....X.X...XX.XXXX.XX..X.XXX
...XXXX.XX............X...XXXX....XXXX......X....XX.....X..XX..X....XX....X....XXX....X..X..X.XXX
XXXXX....XX...X...XX..XX.....XXXX......X.XX.XXX.....XXX.....X....X..X..X.....X...XX...XX....X.XXX
.......X....X...X....XXX.XX..XXXXX...XXX..X...XXX...X....XX.X......XX....X.....X......X...XXX.XXX
..X..X....X......XX....X....X..XX..X.X....XXX...X..XX.XX..X...XXX.....X....XX...XXXX..X....XX.XXX
X.X..XX...X.XX.X....X.......X.....X....XX..XXXX.X.....X...X.......XX....X..X..X...X....XXX.XX....
..X...XXX...XX.X..X...XXXX....XXXXX.X......X..X...XXXXX.XXX....X...X...XX..X...X....XX...X..XX...
.X..X........X..XXX........X....XXX...XXXX....X..XXXXX..XXX..XXX.X.XX......XXX...X.XX.......X....
...XX..XXXXX....XXX.............XXXXX.........XXXXXXXX...........X....X....XXXX..X....X.......X..
