16 16
..........X.....
....X.....X..XX.
X.....XX..XX....
X....X....XXXX..
.......XX.......
.X..X........XX.
.XXX..X.........
..XX........X...
X......XXX....X.
...XXXXXXX.X....
.X..XXXX........
....X.....X.XXXX
..XXX...X.X..X..
..XXXX..X....X..
........X.......
........X.......
