12 12
....X....X..
.XX.........
.XXXXX....X.
.XXX.....XX.
.....X...X..
.....X..X..X
...X.XX.X...
...X......X.
.......X....
....XX...XXX
.....X......
.....X......
