9 9
.........
.........
.....XX..
.X.......
.X..X.XX.
.XX.X.X..
.X......X
...X.....
.........
