81 83
X...X...XXX...X....X........X.....X.....X....X.................XXX...XX.....X......
..X...X.XXX...X..X..........X..XX....XX...XX.......XXX......XX...X.X..X.....X..XXX.
.X....X.XXXX..XX....X..XXX..XX.....X.....XXXX.X....X...XXX.....X......XX....XX.....
.X......X.....X...X....X....XX..XXXXX......XX...X....XXXXX.X.X.XXXX......XX..XX...X
.....X....XXX...X.X..X.X.XX.....X.......X...XX....X..X.......X..X.....XXXXXX....X..
XXX.............X.XX.X......XXX....X......X..XXX.....X....X...X.X.XXX........X.....
....X.XXXX......X.X.....XX..X....X.XXX.X...X.........XX.......X...X..............XX
...XX..XXX.X....X.X.X......XX......X...X...XX.........X..X...........X....X.XX.....
X....X.XXX.XXX..X...XXXXX...XXXXX..X....X..XX..X...XX.XX.XXXXX.....X...X....XX.....
..X....X....XXXX....XXXX..X...XX...XXXX....XXX.X.X..X..........X...X..X..X...XX....
.XX.......X....X.......X.......X...XXX...X...X...XX...X.X.....X..X.XX...X..X.....X.
...XXXXXX..X...X...X.X...X...X...XX..X.X..XX....XX......X.....X.XX.X....X......X.X.
XX...XX..X.X.....X...X.......X....X....XX.....X....X.XX..XX...X..X...X..X...X......
XX.......X......XX..X.....XXXX..X...X...XXXX....X....XX..X..X..X..XXXXXX..XX..X...X
....X.......X.XXXXXXX.X....XXXXXX..XX.X....X...X....X....X.XXX.XX.....X..X...XX...X
.XX.X.X...X.X...XX..X...XX..............XX..XX.X......XX.......XX..XX.X......XXXX..
....X.X.X.....X.....XXX...X.....XXXX........XX.XXX...XX.....X...X..XX.XXX....XXX...
XXXX....X.XX...XXXX..XX...X.XX..XXX....XXXXX.....X.X.XX.......X.XXXXX....XX..XX..XX
...X.X.......X....XX.XX.....XX.XXXX.XX........XX...X..XXX....XX...XXXX...X....X....
.X.......XXXXX..X..X.....XX....X..X.....XXX...XXXXXXX.....XX.XXXX..X...XX..XX....X.
....X......XX....X.XXX...XX...XX..XXX.X.XX..X......XX..XXX.....X...X...X..X..X.....
X........X.X..XX.......XXXXXX.XX...XX..............XXX...X..X....XX....X.....X..X.X
...........X.XX...XX....X..XX..X.X.....X...XX.......XX.X....X.X.....X.....XX..X.X.X
.X....XXX.......XXXX..X....XXX...X..XX...X..X.XXXXX..X.XXXX...XXX..X..X.....X.....X
...X......XXX....X..X..XXX...XXX....X....XX......X...X...XXX..XXX..X...........X...
XX...X......XXXX....XX.XX....XXX......X......XX....XXXXX.....X..X...XXXX.....X...X.
XXX..X.X....X...X...X.....X...............X.....X.....XXX....X....X....XXX.......X.
.....X.X..........X...X.XXX.....X.X....XXXX....XXXXXX.....X....XXXXXX....X.........
.X...X.X...X...X......X..XXXX...X...XX...XXX...XXXXX......XXX.....XXX.X....XXXX...X
...X.X.X.X.......XX......XX........X.....XX....XXXXX.XXXX.........X.....XXX.....X..
X..X.....X..X...X...XX....X.XX.X.....X......X.....XX.XXXX...........XX....X........
..XXXXX...X.X.......XXXXX....X....X......X....X....X....X.........XXX...X..X...XX..
.X......X.....XX.....X.....X....X...X.X....X.....X......X..X......XX..X....X.X.....
...X.......X.......X...X......XXXX..X...X......X.X..XX...X...XXX..X..XX..XXX.....X.
.......X.....X......XX.....XX......X....X...XX...X.....X.X..XXXX..X...X...XX..XX.X.
....X..X....X..XXXX.............X..X.XX.X....X.....XX..X..X.......XXX...X..XX......
..X.X....X..X...XX....X...XX....X....XX....X...XX.....X...XX....X.XXXXXXXX..X.X...X
......X....X..X....XX.X.XX...X....X......X......X.X...X....X.XX...XXXXX.....X...X..
...XXXX...XX........X...X....XXX.......XXX..X...X.....XXXX..........XXX......XX.XX.
XXXXXXXXX...XX......X.....X..XXX...XXXX..XXXX.XX.........XXXX...........XXXX....XX.
XXXXXXXXXX..X..XX.....XXXXXXXXXX.X...............XXXXX...XX......X.X.........X..X..
...........XX...X................X...XXX....XX.XXX..........XXXX...X...X.X...X..X.X
........X.......XX...X.....X.....XX..X...XX....XXX....X.X....XX.....X..X........X.X
........X...XX.....X...XXX...XXX....XX.X..X.....XXX.....X.XX.XX.XXX.X.XX..X...X.X.X
.....X....X.....X..XX.......XXX.....XX....X.XXX.X...XX....XX.X..XXX....X....X.X...X
..XX...X....X.X.X..XX.XXX.......X...X..XX...X...X......X..X..X.XXX...X...X....X....
X..XX....XX.X.......X..XX....XX.....X...XX..X......XX.....X......X.XXXX..X.X.......
...XX.X.X...XX...XX.XX.......X..XX....X....X.....X..X.X.X..XX......X.....X.....XX..
.X....X.....XXXX....X..X...X...XXXXX.....X.X.....XX...X..X....X......X...X.........
...X.....X........XXX......X.....X...X...X.X....X...XX...X..X...XXX....X...XXXXX...
XX...X.X...XX.........XXX..........X...XXX...XX...X....X............XX...XXXXX.....
XXX....XX...X.XXXX......X...X...X..X......XX..X..........XXX.....X........XXXX.X...
....X.....X...XXX....XX.XX....XXX..X...XX.....X.XX...XX..XXX...X...XX...X....X...X.
.X..X...XXXX....X.XX....X..X...XX..XX.......X......X..X..XXX..........X.........X..
.XXX..X.XXXXXX..X...X.....XXXX.....X..X.XXX....X....X.....X.....X...X...XX..X.X...X
.....XX...........X.X.XX..XXX......X.XX.X....XX..XX.X.....X.X.....X.....XX....XXX..
XXXX..XXXXX....X..X.X....XXXX.XXXXXX..X....X....XXX.X....X..X.XX....XX...X.........
......X......X...XX.XXXX....X.....XXX....X..........X..X...XX....X.....X.X.....XXX.
.XXXX....X.X.XX.....X.....X.X...X.X..XX...X......XXXX..X..XXXXXX...X.......XXX.X...
.......X.X......X......XX.X...X.X....X..X......X..XX.........XXX..X.....XX.......XX
XX.....X...XX.X....X.X.X..X..X.......X.XXX.XX..XX........XXX.XXXX...X........XX.X..
...XXX......X....X.X.....XX..X.X.X.........X..XX....XX.......X..X..XX...X....XX....
.XXXXXX...X....X......X...XX.....X.XX.XX...X.XXX.X...X....XXX...X...XXX.XXX..X.....
........X....X.XX...X...X..X.XX....XX.XX.X.......X.X.X..X.....X.X...X...XXX....XXXX
........XX...X....X.....XX...X......X.........XXXX.X....X.XX..X.XX........X...X....
.....X.....X..X...XXXX.........XXX........X....XX.......X.XX..X......X......X...XX.
..XX.X...X....X..XXXXXXX......XX...X........XX....X........X..XXX.X......X......X..
XX...XXX...XX.XX.XXX......XXX..........XXX..X.........XX.X...X....X.X......XXX..X.X
.....XX....XX..X...X.XX.....XX..X...X..XXX..X.XXX..X.....XX..X.X....XXXXX......XX.X
.XX..XX....X...X.....X......XX....X.X.XXXX..X..XXXX..X......XX...X....XX..XX......X
....XXX...X..XXX....XX.X.......X..X......X..XX..X...XXXXXX..X....X.......XXX.XX....
XXX.....X.X...XX.....X.XXX.......X...X......X...X...XXX.....X..........XXXX..X...X.
.....XXXX...X.XX...X....XX.........XXX....X.X.......XX..XXX.....X....XX.....XX.X...
.XXX...XXXX.X...XX..X.X....XX.....XX......X...XX....X..XX....XX....X...........X..X
....XX..X.......XXX...XX......X....X.XX...X....X....X.XX.........X.....X...XX.....X
XX....X....XX.....XX.........X...X......X....X......X....X.....X.X..X....X.XX...X..
...X....XX..X.XXX.......XX...X.X....XXX....X..........X......X...X....X..X.X.......
..XX.X..X...X..XX...X...XX.XX..X..X......X.........X....X..........X..X....X.X...XX
X..X.X.XX....X.XX.....X.X..XX..........X...XX.XX.....X........XXX..X..XXX......X...
XX.X.X.X...X.......X....X.X...X......X..X..XX.....X.XX.X.XXXX.XX.......X....X....X.
XX...X...X....XX.....X....X.....XXXXXXX.........X...XX...XXXX....XXXXX...XX........
