19 19
X....XXX..X..X.....
X.XX..XX..X....X...
..X...XX....XXX..XX
.XX.XXXX...XX...XXX
....XXXX...X.......
X...X....X...X.XXX.
X.X........X.......
X...XX.XXX.......XX
X......X..........X
...X......X.....X..
.X.X.XX.X...X......
.X...X..X.....XX.XX
....XX........XX...
..X......X.......X.
X....X...X...XX..X.
..XX....XX......X..
.XXXX.X.XX..XX....X
....X....X...X.....
..X....X...X.......
