13 15
........X......
......X.X....X.
........XXX....
...XXX...X..X.X
.......X...XX.X
..XX..........X
XX....X.XX.....
....X.X....XXX.
.XX............
...X...XXX..XXX
....XX......X..
........X......
........X......
