82 82
X........X....XXX.......XX...........XX......X.........X....XX....XX..X.........XX
X.XXXX.....XX.....XXXXX....XXX..........XXXX...XXXXX.....X..XX....XX....X.......XX
X....X..X.X..............XXX........X.......X...........XX.XXX...XX..X....X.....XX
..XX..X.X....X.........X..XX..X.X.....XX....X.......X....X.....X.XX.XX.X....X...XX
....X......X.X...XX....XX...X.X....X.....X..X..XX...XXXX....X.......X......XX...XX
.......X...X.X...XX.X..X....X....X...X......XXX...XXXX..X.......X.....X.XX......XX
...XXXXX.X.....XX.....X..X.....XXXX....XX...XX.......X.......X..X....XX......X..XX
.XXXXXXX..XXX...X..X....XX..XX..XXX.X..XXXX..X.X.X.....XXX......XX...X.........XXX
....XXXXX.......XX.X.....XX.X...X...X..XXXXX...X.............XX.XX..X..XXX..X..XXX
XXX.X......XXXX......XXX......X.....X..XXX.....XX.........X..XX..XX.X...XXX...XXXX
XX..X.XX...X....X....XX....XX.........XXXX.....X......XX..X.XXXX..X..XX...........
XX....X..X.....XX.......X...X......X....X......X....X.....X.....X..X.X.......X....
......X.X.........X...X...X......X...X....X.........X...X.XX.....X.....X.......X..
........X.X...X.....X.....XX...X....X..X....X...XXXXXXX.X....X.X......XX....X..X..
XXXXXX......X....X....XX.....X.X..X...XX.X..X.....XXX...XXX....X..XX..............
..XXX....X.....X...XXX...XX....X.....XXX.X..X..XX.....XXX...X......X..X....X....X.
....X.XXXX.X....X..X...XXX..X.XX.X...XX..X..XXX.......XXX.X....XXX..X.X.......X...
.XX...X......XX...X..XXX...XX.X....X....X.....X.XXXXX...X..X...XX...X...X...X..XXX
...XXXX...X....X....XX...XX...X.X....XXXX.......XXXXXXX....X..X...X.......XXXX....
XX..XXXX..X.X....X..........X....XX........X.....XXX........X.X.XX.......XXXXXX...
..X...X...X...X.......X...XXX..X....XX...X.X...X.........XX...X....X...X..........
....X.X.X.......X...X...X......XXXX....X.X...X......X..X..XX......XX.........X....
.XX.X...XX.....X..X.....XXXXXX........XX........X......XX....X............XX...X..
..X.....X..XXX...X..XX..........XX........XXX...X....X...X..XX...X.XXX......X.....
X....XX.X...X......XX..X.....XX......XX.......XXXX.....X.X..XXXX...XXX....X...X.X.
...XXXX.....X.XXX.....XX...X.XXXXXXXX...XX.....XX...XX.X....X.....XXXXX.......X.X.
.X....X..XXX..X...X....XXX.X....XXXX........XX.XX.X..X.XX...X...X..X....XX....X...
.X........X..XX......X.X........X....X.........X..XX...XX...XXX.XX...X.......XXX..
..X....XX...XX.....X.X....X..........X.....X.....X........X.....X....X.XXX...X....
X.X.X...XX.....X........X...XXXX.X....XX.X.....XX..XXXXX..X..X....XX.X...X..XX....
X.....X..XXX........X....X..XXXX....X.XX....X..XX...XX...XX....X.........XX.XXXXXX
...X...X..XXXXX...X....X...XXX..XXX.......X...XX....X.......XX......X.....X.......
.X...X..X....X..X....X.....XXX.......X......XX...XX...X.X....X..XX........XXX.....
........X..X...XX....XX......X...XXXXX..XX..XX.X......X...XX....X..X.......XX....X
..X...XXXX..............X......XXX...XX......X...XXX..XX..X...X...X...XXXX.XXX....
....XXXX.........X.....XXXX........X.....XXX.....XX......XX.X.XX....X......X....X.
...XX.......X........X...............XXX..XXXX......X.......X.X..XXXX..X.....XX.X.
....X...X...X.X...XXXXXXX..XXXXXXX.....XX.......X.XXX...X.XX....XXXXX.........X...
XXX.XX......X..XX..X.......X....XX..XX........X.X..XXX....XX.X...X..X...X...X.XX..
XX..X..X.....X.X...X.XXXXX...XX.XXX...........X....XX..X.........X..X.....X.X.XXXX
XX.XX.XXXXXX.....XX..X.....XX...X...X....XXXX.........XXXXX.........X.....X.......
XX.XX....XX...X...X.X..X......XX....XXX......XXX...X..XX........X...XXX...XX.XX...
...XXX......XXX.X.....XX.XX....X.X......X........X...XX..X..........X.....XX.XX...
.XXX......XXX...XX...X.......X...X.X......X...X...XX.XX........X.......X..X..X....
.X...XX...XX....X..X......XX.....X........X.X...X.XX......XX...XXXXX.X.X..X....X..
......X......X..X.....X.XX....XX....X.....X.....X.XX..........XXXXX..X...X.......X
X...X.....X....XX...X...X..XX.XXX.....XX....XX....X..XXXXXX.X...XXX........XX....X
..X....X..X.......XXX..XX.X...XXX.XX..X.....XXXX....XXX..XX.........X.........X...
.....X...X....X....XX...X...XXX...X...X..........X....X...XX...XXX..X...........X.
.X.........XXXX.XX.XX.X.XX...X....X.X.XXXX.X.....XXX....X.X..X.....XXXX.XXXXXXX...
.X.XX.....X.....X..X....X..X...X..X.X...XX....X..XXX........XX...XXXXX..X.........
.X.XXXX...X....XX....X....XXXXX...X..XX.....X...XXX......X...........X.........X..
...XXX....XX......X.......XXX...X....X...X......XX..X...XX......X......X.XX.......
X..X...X........X...X.XXX.XXX.XXX......X.....X.....XX.X.XXX...X...X......XX..XX.X.
X..X.XXX....X.XX......XX....X.....XXX.....XX...XXXX...X.....X....XXXX.....XX..X...
X..X..XXX...X....X.......X...XXX........XXXXX.........XXXX.....X...X....X...X....X
....X......XXXX.......X....X.XX..X...X..XXXXX..XXX...........X.......XX...X....X..
.XX.XXXX.X......X.........XX....XX.X..XXXXXXXX...X...X....X..X..X......XX....XXXX.
....XX...XXX...XX.XXXX.....X..X....XX..XXXXX..XX...X....X.X..XX......X..XX....X...
XX..XX.......X..X........X.XXXX.X....X.XXX....XX......X.X....XXXX....XX.....X.....
...X..XXXXX.....XX.....X...X....X......X...XX.X.....X...XXXX........X..XX.X.XXXX..
...X.......XX......XXX....X..XXX....XX.....X..X.X................X..X.....X.XX....
..XX...XX..X........X..XX...XXX..XXXX......X.......X...XX..XX....X..X...X...X..XX.
..XX.X....X..XXXXX..X..X.....XX...XX..X.......XX.X.XXX.....X..X..X....XXX...X...X.
...X....XX..XXX....XX....X......X....X....X......X.......X...XX..X...XX.....XXX...
.X.XX.X....X......XX..XXXX.XX.X.....X..XXX...X...XX...XX.XX..X.....XXX......XXXX..
....X.X..X...X.X..XX...X...X..XXXXX...X....X.X.X.X..X.XX.X...X......X..X....X...XX
X.X.X....X...X...XX..X.......XX......XX.X..X.....X.X..X....X.XXXXXX...X..X..X.X...
..X....X.....X..XXX.......X.....XX......X....XX....X....X......XX....XX.....X.XX..
.XX..XXX..X..X..XXX.......X.XX..XX......XXX.....X........X..X...X.XX....XX....X..X
......XXX.X..X..XXX.....X....XXXXX......XX..XXX...X....X.X....X.X..X.......X....XX
...XX.X...XXXX...X..X......X...........XXX...XXX....XX.....X.......X......X..X....
.X..X....XX....X...XX..X......X...X....XX..X..XX...XXXX.X....X...XX.....X.X....XX.
..X....X.XX.....XXXXXX......X...X.X.X..XX.....XXX..XX...X....X.X....X.......XX....
X.XX.....X..XXX..XXXXX..X.......X......X..X....XX.XXX....X...X....XX...X.X.....X..
X.....X..X.......XXXXX.....XXX....XX...X.......X.......X.....XX.X....X...X....X...
..X.X...X..XXXXX..X......X..XXXX......X....X...X.X........X..XX.XX..XX..XXX...X.X.
..X..XX...X....X..X...XXXXX......X......XXX..X...X...XX.X...X...X...XXXXX.....X...
.....X......XX....XX..XXXXXX.......XXX......X......X....XXX.X.....X.......XX......
................X.....XX...X............XXXX..XXX...XX...XX.XXXX..XXXXXX..X..XX...
XXXXX.X....XX.........XX.X.XX.....XX....XXX..X....X..X.X.XX.XXX...XXXX....X.X.....
XXXXX...XX....XX.........X....XXX....X..XXX....X..XX...X....XXX...XXXX....X...XX..
