77 78
.....X.....XX...X....XX......X........XX...X...X..XXXXX...XXX..X...........XXX
.XXX....XX....X.X..X....XX.....XXXX......X...X.X....XXX.X...X....XXX..XX......
.X....X.......X.XX.XXX..X.....X...X..X....XX.....XX.....X.....X.......XX..X...
.X.....X......X....XX..X..X...X.X.XX...XX.....X...XX....X...........X.X...X.XX
.XXXXX.X...X..XXX..XX....X..XXX.X......X....X.XXX..X..X........XX...X...X....X
..XXXX..XX.XXXXXXXXXX.XXXX.XX....XX......X......XX.XX....X.X...........X...X..
X....XX....XX.......X....X.XX..X...XX.X....X.XX....XXX.....X...X.....X.X.XXXX.
...X......XXX.XX.....X.....X...X....X....XXX...XXXX....XX...X......X...X..X...
.X....X.....X....X.X.........X....X....X.....X.XX...X..XXXX.X.X........XX.X.XX
....X.........X....X..X.....XXX...X..XXXX......X....X.....X.........X..X..X...
..X...XX.....XX...XX..X.XXX.....XXXXXX..X.X......X..X.X......X.........X...XX.
.........X.....XX.XX..X...X..X...X......X.....X.....X......XXX....XX.....X....
...X...X...XX.....XXXX....XX...X.X..XXX....XX...X.X.XX.....XXXX...XXXXX.......
X..X......X...X....XX..X.......X.XX....XXX...XX.X........XXXX.....X...X.XX....
..XXXXX.XXX.XXX....XX......XX....XXX...X.....XX.XX...XX...X.......X.X.X....XXX
.XXXXX....X...XXX..XXXXX.....XX...XX.....X...XX..X...XX.X.........X.X.XXX.....
...XXX.X......X....XXXXX..X.....X.......X..X.XXX...X......XX......X....X..X...
XX.......X.........XXXXXX...X.X.....X.X...XX.X..XX.XXX.XX.XXXX.....X.X...X....
X.....X....XXXXX...XXXX...XX..XX....X......X.X..XX.XX..XX........X......X..X..
..XX.........XX....XXXX...X..X.....X.....X.X....XX..X...XXX...XXXXX...X.X.XXXX
.....X.XXX......X...........X...XX.X.....X.XX...XXX...X.....X..XX.......X...XX
XXX....XXX.............X...X..X..........X.X....X.....XXXX..XX....XX..........
XX..X...X....XXX.X.....X.X...X....X.XXXX...X.XX............X.....XXX.......X..
XX....X...X...X..X.XX....X...X.XX.X.XX.....X.X..XX...XXX.....X.......X...X...X
...X.....X..X...XX.XX...X......X..X....XX..X...XX..X......X.......XX...X.....X
.X.X.XX....XXXX..X.XXXX...X.XX...X....XXX..XX..XX....XXXX...X............XX..X
.X...X..X........X...X....X..X.....X.....XX............X...X.....XX.........XX
.......X....XX...XX....X..XX......XX.X.X....XX..X...X....X.X.X...X..X...X....X
XXXXX..X.......X..X.X....XX.....XXXX.X........X...X...X......X..XX....XX...X..
..X....X..XX.X....X...X..XX......X...XX.....X.....XX......XXXXX.X..XXX...X..X.
..X....X.....XXX..............XX........XXX..........X.XX...XXX...X......XX...
...XXXXX......XX...X...X..X.......X...X....X.....XX....XX.X.XXXXX...X......XXX
.X.......XXXX...X..X.XXXX...XX.X......X..X.X.XXX..X.X.....X.X...X.XX..........
.X..XX........X...XX.XXX....X..X.X....XX.X......X......X..X...X....X.XXX..X...
.XXXX.....XX..XX...X.....X....XX....X.......X........X.X..XX.....X.X..XXX.....
......X...XX.XXX.X.......X.....X..X...XXX.....XX.XXXXX..XXXXXX........X.......
X...XXX........X....XXXX.X.....XX..X....XXXX..XX.X...XX..XXXX.....X...X.XX....
..X.X...X...X...X...X......X.......X.X.....X...X...X..XX...XX.......X.X...XX..
......X...X...X.....X...X.X....X...X.X...X...X....XXX.......X..XXX..X.XX..X..X
XX...........X......XX....X.X....X...X....X...X...X..XX...X.X.......X....XX...
X.....XXXX.X......X....X....X.....X....XX.....X..XX..X..X.....X.........XXX.X.
X.X...XXXX......X...XXXXXX..X...X...X...XX.X..XX.XX....X.....XX.XX...XX.XX..X.
X....XXXX.....X.........XX....XXX.....X....X..XX..X......X.X....XXXX.......XX.
...X......X.....XX...X.....X.........XX..XX...XXX..........X...XXXX....XXXXX..
......XX....XX.....X...X.........X....X..XX.X......X....X..XX.....X.....X....X
XXX...XX...XX..X...X.XXXXXX.X......XX.X.....XXXX.X...XX....XX.X.X.XXXXX...XXXX
XXX...XX...XX......X.....XX...X.......X.XX..XXXX....XXXX...XX...X...XXXX......
..X....X......X.X..XX.......XXXXX........XXX..X...X...XXXX..XXX..X....XX.X....
.......X..XXX.X....XX.X.X...XXXXXXXXXX.X........X...........X....X.X...X.....X
.XXXXXXXXXX......X......X..XXXXXXX...X.XX......XX....X...XXX..XX.....X....X..X
..X..XX...X.XX.X.......XXX.X.......X...XX.XX.......XXX.X.....XX.....XXX.....XX
X....X..X...XX....XXX...X..X......XX....X......X...XXX....X..X..XXX.....XX..XX
XX...X.X...X....XX....X...XX....X..X.XX.XXX......X..XXX......X...XX.XX..X.....
.....X.X.X.X.........XXX.....XX.XX...X..X...X.......X....X...XXX.X..XXXXX.XXX.
.XX....X.X.XXX..X......X.XXX..X.XXX..X....XXXXX........X.XXXXXXX...XXXX...XX..
....X....X.XXX..XXX.XX.X......X...X.................XX......XX......XXX....X.X
XX....X....XXX...X..X..X....X.........XXX..XX.......X...X...X..XXXX......X....
.....XX..XXXX..X...X..X..XX.XX..............X....X..X.......X...X..X...X.XX.X.
.X....XX.X....XXX..X.XX...X.XX........XX....XX.....XXXXX....XXX....X.X......X.
.X.XX.XX...XXXX....X..XXX.X..X...X....X..X..XX..X....X......XX..XX......XXXX..
...XX..X..X........XX.XXX.XX..XX....XXX.....XXX...X....XX.........XXX....X...X
X..X...XXXX....X...XX.....XXX.....X..X...XX......XX.X......X...XX......X......
.....XXXXXXX...XXX..XXXXXXXXXX....XX...X...XXX...XX......X...X.....X...XXXX.X.
.XXXXX.........X..X.X.......XX..X...XX......X.....X............X......XXXX..X.
..XX...........X..X.........XXX...X..X..X.X...X...X.....X...........X.X..X....
X.X...XX.......X.....X......X........XX.X.X....X..X..X....XXX...XXX...X.......
..X.X..X..X....X..........X...XX......X...X....X..X..X.X......X...X.....XX....
.X.....XX.X...........XX.....XX.......XXX.........X..X.X.X....X.X....XXXX..XXX
...X........X...X.....X..X.X.XX........XX....XX...XXXX...X.XX.....XX..X...XXXX
X........X..X...X.X...X.XX......XXXXXX.XXX........XXXXXX...X........X....XXXXX
X...XX...X.X..X....XX.......X.....XX...X...XX.X...XX.....XXX.....XX....X......
..XXXX.X.X.X.....X.....X.XX...XX...X.X...XX...X.X........XX...XX.....XXXX.....
....X....X...X....X......XX.XX...X.X.....X..X...XXX.XX...X..X......X....X...XX
XXX...X.....XX.XX.X.X...XX..X..X.........X....XXXX..X....X.....X.....XX.X.....
...X..XXX.XXXX.XX...X.XX...XX.....X.XXXX.XXX.....X....X..XXX..........X....XX.
.X....X...XX...X....X.X....X....X...X....X...XX.......X..XX.....X...X.XX.X....
......X......XXX....X...X..X..........X..X......X.....X..XX.......X...XX...X..
