40 40
.X.....XXXX...X.....X..........X..X.....
.....X..X...X...XXX...X...XX...X....XXX.
X.X..X....X..XX..XX..X..X.X....X.X......
..X.XX.......X...XXX...XX...X....X.....X
.....X....XX...X.XX....XXX....X...X.....
XX.X.X.....XXXXX....X...X..X..XXX.X.X.X.
X..X.X...X.......X....X...X..XX...X.X...
..XX...XXXXX.....XXX.....XX.XX..X....X..
...XX....X...XX........X....XX.....X...X
XX.XX..X.................XXX....XX......
...XXX.XXXX...XX......X......XX...X...X.
....XX......X.....X...X.XXXXXXX.....X...
XXX..XX.......X...X..XX..........X......
..XX..X.XX.XX.X....X..X.......XX.....X..
......X..X......XX..X...XXX.......XX.XXX
.......X...X........X..XX......XXXXX....
XXXXXX..X..XXX...XXXXX....XX.....XXXX...
....X...X.XXXX.....X...XXX...XXX.X....XX
....X.....X......X.........X.....X.X..XX
..XXXXXX....X.........XXXX..X......X..XX
.....X...X..X...X........X..X.XXX.....XX
.X.....XXX..XXX.X......X....X..XXXX...XX
.X.XX...X...XXX...X.........XX.....XXXXX
.....XX...X.X..X......X.......X....X....
X.XX......X....X.X.XX...X...X.....XX.XX.
X..X..XX....XX...X........X....X.....XX.
...X.....X....X..X...X...XX..X.X.X...XX.
.X.........XX.X....X.X....X......X.X.X..
....XX......X........XXXX.....XXXX.X...X
X...XX..XXX..XX..XX...XX...X...XXX.XX...
XXX..XX..XXX....X...X....X...X.X......X.
X....XXX....XX....XXX..XXX..XX...XX.....
X.XX....X......X..XXX...XXX.....XX......
X.....X...XX......X.....X....X..XX......
....X.....XXXXXXX....X.....XXX.XXX..XXXX
.X...XX...XXXXX..X...X..XX.X.....X......
...X......X...X......XX..X.X.XX....X....
X..XXXXX..X.X...XX...XXX.X......XX...X..
...XXXX...X....XXX.X.X......X...X....X..
...XXXX...XX.......X...XX.....X...X..XXX
