98 99
..X....X...XX.....X..XXX......XXXXXX.......X....XX...XXX..X........X......XXXXXX...X...XXX.........
..X.XX...X.XX.X...X..XXX.XX......XXX.X.......XX.X..X...X....XX...X...X......XX...X.X.X..XX.XX....X.
....X...XX..X....XX......X.....X.XXX.X....X...X...XX.....X.....X.........X...X.......XX....XX..X...
.XX...X..XX....X....XX...X.X...X...X.X..X.....X..XXX..XXXX.XX..X..X...X....X......X...XXXX..XX..X..
.XX..X...XX.......X....X...X.......X.X..X......X....XX.....X...X....X...X.....XX....X....X..XXX....
.XXX...X..X..XX........X..XX....X....X.......X......XX....XX...X...XXX....X......X..XXXX.........X.
......XX..XX.......X...X...X......XXXX...XXX....X...XXX.......XX....XX.X..X..XX..XXXXXX........X...
..XXX.....XXXXX..........X.XXX.X....X.....XX..X...X........XX.XX....XX.X....XX.......X..X...X..XX..
..XX...XX....XX..XX...XXXX...X....X.X...X...XX....XXX..X....X....XXXXX...XX....X.....X....X...XXXXX
.....X...XXX.XXX...XX..XXX......X.X.XX..XXX....X...XX...XXX.X..XX.......XXX..X...XX.......XX.......
...........X.X.....XXX...X..X.......X..XXX.....X.X....X.....X.........X..XX.....XXX.......X..XX....
XXXXX...X....X......X....X....XXXX....XXXX.......X..XXXX...X..XX...XX....XX...X...XXX....XX.XXX...X
...X..XXX.X.......X...XX......XXX.........X...X.....XX...X...XXX....XX...XXX........X.XX..X..XXXX.X
...X...XX.XXX...XXXX..X...X...XX..XXX.......X...X....X..XXX..XX.....XX.X...X.X...X..X..XX....X....X
..X....XX.....X.......X.X.....XX.........X........XX..X.X...XXX........XXX.X.X.XXX.XXX..XX.....X..X
....XXXXXXX.....XXXXX......X..XXXX...X.X...X...X......X...X...X.......XXX..X.X..X..XX...X..XX....XX
...XX.............X......X...XXXXX.X.X..XX...X...X.XXXXXX.......XX......X....XX...X...XXX.X........
....X...XX..........XXX..XX..X..XX.X....XXXXXX..XX.....XX..X...X...X....XXX...X..XX.XXXXX.X.XX..XX.
XXX......X.........XXXXX....XX...X........XXXXX....XXX...X.X...X..XX........X.X.....X.......XXX....
XX.....X.XXX........X..X.X.....X......XXX......X......XX.X...XXXX....X..........XXXXX.XXXX......X..
XX.........XXX......X..X...X.XXX......XXX....X......X....XXXX..XXX...XXXX....X...XXXX.....XXXX.....
X.......X..XX..X.......X.....X.......XX...X....XX......XXX.....XXX.XXXXXX.XX.XXX..XXXXX.......XX...
X.XXXXXX..XXX....X...X.X....XX....X.....X...X......X.......X.........XXXX.......X.......XX....XXXXX
X....X...X..XXX....X.X.......X....X.X.XXX.XX..X....XXXXXX..X.....XX....X....X...X....X..XX...XXX..X
.....X...X.....XX.......XXXX....XXX...XXX.XX.....XXXXXXX.......X....X....XXXX..X..XX...XXX.X...X...
....XX.....XXX....X.XX.....XX...XXX..XXXX..XXX.X.XXXXXX..X............X...XXXX...XX.....X..X.....X.
..X.XX....X.....X...X..X.X...XX..X....XXXX...X.X......X............X....X.XX....X...X.X.X.....XX...
..X.....X.....X....XX.X..X.......X..X........X..XXXXX.....X...X......XX.X.......X.XXX.......XXX....
....X...X..X..XX....X...X.....XXXXX.X...X.....X........XXXX.X.....X.......X...X......X...XXXXX..X..
.X......XX.X......X....XX.X.X...X.....X..XX.X.X......X...XX....X.....X.XX.....X..X.X...XXXXX...XX..
...X.........X.......XXX..X...X.X.XX...X....X.X...X......X...X...X.X...X.......X.X....XXXX.....X...
..X...XXX...XX.XXX....X..X....X.X.X..X.X........X...X......X...XX..X.....XXXXX......XXXX...XX....X.
....X...XXX.........X...X..XX.X...X....X.XXX.......XXXXXX..XX..X..XX.XX.........XX............X....
...XX....X....X.....XX....XXX....XX......XX......X......X..X...X.....XX...X........X..X...X...X...X
.......X...XX....X.....XX..XXX...XX...X..XX.XXXXXXXXX........X.XXXX..XX.......X...XX....X...XX..X.X
..XX.X......X..X..XX.X.....XXX..XX..X.....X..XXX.......X....X..XXXX........XX...X.XX.X..XXXXXX.XX..
..XX.X.XXXX....XX..X...X...XXXX.XX...X....XX..XX...X.X.XXXX...XXXX....XX..XXXX..X....X.XXXX....XXX.
.....X.......X..XX.....X...XX...X..X.....XX...XXX....X.XXX.....XX..XXX....XXX...XX..XX...XX.XX.....
.X......XXXX.XX..X..XX...X......X.....XX.XX.X.....X....XX..XXX.XX...XX..X.....X.....XX....X....X..X
...XXXX...XX...X..XX.........X....XXX.....X......XXXX.......XX....X...X...XXXXXXX...X...X...X..X...
X...XX....X.......X..XX...XX.....XXX..X.X......X..........X...X.......XXX......XXXX...X..X....X..X.
..X....XXXX.X...XXX.XX..X..X..XXXX...XX.........X....X........X.........X..XXX.....XXX...X.X....XX.
.....XXX....X....XX..X.X...X...........X........X.X..X..XX..............X...XX..X......X.....XXXXX.
XX....XX...X.....XXX...X.X.X.XXXX........XXXXXX......XX...XXXXXX.XXXXXX...X...X...X.......XXXXX....
X...X.XXXX.X.XXXX.....XX.X...XXX..X.....XXXXXX...X...XXXX....X...XX...........X.XXXXXXX...........X
..X.X...XX...XXXX...X....XX..XXX....X.XXXX.....X..XXX......X...X.....X...XXX..X.....XXXXX....X.....
.XX.....X.....XXXX..XXX.....XXXX....X..X......XXX.....XX...XX....X.X...X......XXXXX.......X..X...X.
...X........X.X....XXX..XX.....X.....X....XX..X...XX...XXX.XX.X....X......X...XXXX...X......X....X.
XX.......X..X...X..XX..X...X.X.X...X..X...X..X..X.XX.X.XXX..X..XX.......X.....XX...X....XX..X.XX...
..X.X....X.X....X...X........X...XXXX...X...XX.....X........XX....X...X....XX....XX...X.....X.XX...
....X..X.....X....X.......X...X...X......X.....X.X....X....XXX..X...X.X..X......XX..XXXXX...X.X....
.X...X.XXXX....X.XX..X......X...X......X...X.....XX.....XX...X..XX..X....X.X.XX....X........X...X..
.X.X...X.......X.........X..XX..XX.....X.....XX........XX....X..XX.XXXXX...X.XX.........XX..XX....X
.X.XX..X.XXX..........XX.X..XX..X....XXX.....X.....XX.....XX....X..XXXXXX....X..XXX.XXX.XX..X......
.X.XX..X.X....X.XXXXXXX.......XXX.....XXX....X........X.XXXX..X...XX...X....XX.X..X..XX..X..X....X.
.......X....X.X.X.......X.....XXXXXXX.....X...........X..X....X...XX...X.XXX...X...X...X...XXXXX.X.
X...X....XX...X..........XXX....XX.....X....X.XXXXXXX.XX...XX.....XX..XX.......X.X.....XX........X.
....X.X...XX.....X.....X..X..XX....X.....X....XXX...X.X....X...X..XX..X...X......XXX......X.XXX....
.XXXX...X......X...XXX..X...XXX..X.........X......X...X......X.X........X...X...X......X....X...X..
....X..XX.............X.X........X.XX.....XX...X....XX....X......X...XXXXXX...X...X.X..X.X....XX...
XXX..X....XXXXX...XX..X.......XX....X.....XXX....X.....XX.....X....X..XXX.......XXX...X..X....XX...
..XX.X...XXXXX....X..X...X.X..X...X...X...X...X....X.......XX...X..XX............X....X...X....XXXX
...X..X....XXX.X....X..X.X.X.XX.XXX.....X.......X........X......X....XXX...X...X...X......X..X...XX
.X....X.X......X.X..X.X....X....XXX..X....XX........X....X.X......X...X..XXX.X....XX.X.X.....X....X
..X.....X...X......XX.X.X...X....XX....X...XXX...XX....X.X.XXX......X...XX......X......X.X...X..X..
X.X..XXX..X...X.....X.....X...XX.X..X..X.X.....X.....X.X.......X.....X.....XX.X.....X....X...X..XX.
..XX.X...X........X....XX.....XX...X...X..X...XX...X......X........X......X...X..X..X...XXXX..X....
...X...X...X...XX....XXXXX........XX......X.X...XX......X.X...X.XX......X...X....X.X..X.....X...X..
XX.XX......X...XX....X.....X...X..X..XX.X.......X...XXXXX...X...XX..XXXXX..XX..X.....XXXXX.....XXXX
X..XX...X....X..........X..X.XXX.XX.....X.XX......X............XXX...X..XX...X..X.XXXX.....X.X.....
X...XX....X...........X..XX..X...X..XX......XXXX...........X....XX.X....X..X..X.X..X....X..X....XX.
....X..X....X.XXXXXXXXXX.XX....XX..X...X.X..XXX..XX......X.XXXX....XX...X.XXX......X..X...X...XX...
.XX...XXXX....XXX....X......X..XX.X....X.X.XXX..X......X...XXXXXX..X..X........X...X..XX..X......XX
........X....X....XX....X....XXXX...X..X.X.....XX....X.XX.......X..X.......X.....X....X..XX...X....
XXXX......X....X..XX..X....X.......X...X....X......XXX..........X..X...X.....XX...XXX...X...X...XX.
XXX....X....X..X...X.....X..X........X...XX....XXX..X...XX.....XXXX..XXX....XXX.X....X....XXXX..XX.
XXX.XXXX.X....XX.X...XX.....X.....X..........X..XXX...X.....XX...X..X.....X.X...X..X...X...XXX..XX.
X...XXXX...X.....XXX....X.X.......XXX.....X...X....X....XXX..XX....XX.....X.X.XXXX....XX.X......X..
X.....X......XX...XX...X..X..X....XXX.......X.XX.....X..XXXX..X.X...XX..XXX.X..X...XX.......XXX...X
....X...X.......X..XX..X.XXX.XXX....X.......X..X.XX..X......X.......X...X......X....X...X.X........
.XX.....XXXXXX..XX....XX.X...XX..XX...X.....XX....X....X....XX........X....X......X...X...XXX....X.
.XX..X......XX..X......X.....XX............XXXX.X.X.......XX....XXXX..XX.X...XXXX....XX..X....XX...
.XXX...X.X..XX..X.XXXX....X..X..XX...X...X..X...X.X.....X.XX.......X..XX..XX..XXXX....XX.....XXXX..
.......X...XX...X..X....X....X.....X.X...XX.X.......X...X......X.X....X...XXX.......X..X..X.......X
XXX....XX.....X..X....X.X..X...X.......XX......X.X....X.XXX..X...X....X......XX...X..X..X...X.....X
....X.....XX...X....X...X.....XX....X...X..X.....X...XX..X...X..XX.XXX.......X..X..X....X..X....XXX
.XX.X...XX...X....X.........X...XX..X.X....X.XX.XXXX...X.X.X....X....X.........XXX..XX...X...X..XXX
....X....X..XX..X........X....X.X...X.XX...X.XX..........X.XX.....X.....XXXXX....XX....X.....X.....
...X...X..X.XX.....X.......X..X.X.X.X...XX.....XXXX...XX...XXXXX....XXX.....XXX....XX..XX......X...
.X...X..X....X...X.......XX...X...X..XX.XXXXX.......X......X..X.......XX.....XX.....X..XX.....XX...
.XX...X....X.X.X....X.......X......X.XX.......X.........X..X....X.....X..X.X..X...X....X....X......
....X.X..XX....X.XX.X...X.XXX..XXX.X...XXXX.......XX.......X.XXXXXXXXX..X..XX...XX.......X......X..
XX..X..X....X.....X..X..X..XX..X....XX......XX.XX.XX...X.X.X..XXX......XX...X..X...XXXX....X.XX.XXX
....XX.X...XXXX.X....X.X...X......X......X..XX.......X.X...XX..XX.........X..........X..X..X.......
....XX.....XXXX.X........XXX.XXXX....X...X..X......X.......XXX.XXX....XXX.XXXXX......X.........X...
XXXXX...X.....X.....X.....XX.....X.X...XXX..X.XXXX....X.XX.....X....X..X..XXX..........XX...XXX....
XXXX..X...XXX....X........XXXXX..X.....XX...X.XXX...X.X...XX......X.XX...XXX..X.....XX....X.XXX.X..
XXXX...............X............XXXXX..XX...X.....X...XXX....XXXX...XXX..XXX....XXX....X..X.....X..
