16 18
X....XX...X...X..X
X.XX....X.X.X....X
..X.....X.X.XX...X
.X..XXX.X...X..X..
.X....X.....X.....
....X.........X...
X...X......X......
...............X..
.X...X......X.....
.XXX......X.....X.
...XX.X......XX.X.
X.....X....XX.....
X.X......X.....X.X
X.XXXX...X.X.X.X..
X..X...X...X...XX.
XX...X............
