13 14
........X.....
..XXX.....XX..
...X...X...X.X
.X...X...X....
.XX...X.....X.
....X..XX.....
X....X...XXX..
...X.......X..
......X.......
..X.X.X...XX..
..X.X.X......X
....X........X
.............X
