11 12
.........X..
......XX....
XX..........
...XXX......
.XXX......X.
.....X......
XXXX...XXX.X
.......X...X
..X....X....
..XXX.....X.
........X...
