8 9
.........
.X.....X.
.X...X...
.X.......
.X....XX.
.X.XX....
.X.......
.........
