6 8
........
....X...
........
...X....
.....X..
..X..XXX
