108 110
X...XXX..XX...XXXX..XX..X......XXXXX...X......XXX....X.......XX....XX....XXX..X.........XXX...X...XX..........
X.X...X.....X....X..XX....X....X...X...X......XX..XX...X........XX....XX...X....X..X......X.X...X....X......X.
..X.....XXX....X.X...X.X....X..X.X.X..XX.....X...XXX..XX...XX.XXXXX...XX.....X.....X...X....XX.....X...XXXX...
.X.....X.....X.....X...X.X....XX.X.X.....XX....XX.....XXXX.XX.......X.XX..X....X...XXX...X...X.X.X.....XXX..XX
...X.XXX.X.X.XX.X...XX.....X.....X...X....X.X.......X....X....X....XX..XX...X..XXX...X.....X.....X.XX...XX....
X....X.....X.XX.X.X.....XX.X............X........X.....X.X..X...X..X...X..XX...X...X....X.....X.......X....XX.
..XXX..XX.XX..X.......X..X.X....X.....X....X.XX....X...X.....XXX..XX.....XXX...X.X....X...XXX....XX....X....X.
......XXX..XX............X...XX...XX...XX....XX.X.XX.XX....X...X.XX..XX..X....X..XX......X.....X.X...X....X...
..XX.....X..........XX...........X...X.XX.X.......XX....X....X....X...XXXX.XX.X.X......X.....X.....X....X....X
...X.......X..XXXX.......XXXXX.......X.......X...XXXXXXX..X.....X.X.X.XXX..X..X......X....X..XX...XX..XX...X.X
.X.XXX..X....XXXX..X............X....XXX.X.....XX.....X..X..XX....X.......XX.X.......XX.....XXX..........X.X..
...XXX....XX...XX.XX..X.......X...X....X....X...X...X...X..X.....X...X....XX...X......X.......XXXX...X..XX..X.
..XXXX.....X......XXX...X.....X.....X.....X...X.......XXX..........X...XX.....XX.X....XX...X....XX...X......X.
..X........X..XXXX........X...X.......X........X...XX.....X.......XX......XXX......X..XX.X...X...X..X..XX...X.
....XX..XXXX....X....X......X........X...X...X...X..X..XX.......XXXX....X....XXXX.....XX.XX..X.X.X....XX..X...
.X......XXXX..X...X......X....XX.XXX...X...X....X...X...X.....XXX.....XXXXX....X......X..XX..X.X...X.....XXXXX
......X..XXXX....XX.XX.....XX..X........X.......X.X...X...XXX..XX...X.......X....XXX....X......X......X.......
X.X...XX..X....X....XX..X...XX..X...XXX.X.X...X...XX......X..X...XX.X....X....XXXX......X.XX..XX....X...X.XXX.
X.....XXX......X......X.....XXX...X...X...XXX.....XX...X..X......X....X..XXX........X...X.....X...........X...
XXXX.......X.X...XXXX..XXXX....X..........XX...X..XX.....X..XX.....X....XXXXXXX...X.......X...X.XXXX...X....XX
..X..X.....X...XXXX..X..XXX..X...X.....XX....X..........XX...X..X..XXX......XX..X...XX......X...X....X...X..XX
....XX.XX..XX.....X.....XXXX....XXXX.XX.........X..........X..X...X....XXX.....XXXX.XXXX.XX.....X..........XXX
...XXX..X....XX.X.X......XXX..X...X..XX.XXXXX.XXX........X....XXX.X.X...X..X.XX.......XX..X.....X....XX.......
.....XX.X.....X.X.....XX...XX.....X.....XX..X.XXXX..........X..X....X.X...XX....X..X......X..XXX..XX....X.X...
XXXX..X...X.X...XXX...X....X...........XXX....X......X..X.XX...X.X.......X...X..X....X....XX...X......X...X..X
..X...X.....X....X..XX..X....X.....XXX...X...XX.X....XXXX.X..X.......XX..X.X...XX......XX.........X...XXX..X..
....XXX..X....XX...XXX.XX..XXX.....XXX...X.X..X...X...X...X.X..XX.XXXXX.XX.X........X.....X.....X...X......XX.
.....X.....X..XXX..X...XXX.....X.X..XX.....X..XX..X.X...X...X..XX.......XX....X.......X...X..............X..X.
XXXX...XX...XXXXX..X.....X.......X..XX..X........X..X.......X.....X....XX...X...X..X.....XXXXXXX.....X...XX...
...XXXXXX.X.....X....XXX.X....X.....XXX.....X...XX....XX......X.....XX....XXX...X..XXX.X.....XX..XX..........X
...XXX..X....XX...XX..XX.X..X.....X......X....X....X..XX...X............XXXX....X......XX....XX.....XXX...XX.X
..X..X...X...XX..X..X....XXXX..X.......X...X.....X.......X.....X..XXX.X......X....X.......X.......XXXX..X..X.X
..X....X...XX.......XXXXXXXXXX...X...........X...XXX.......XX....X..X........X.X..X....X....X.....X....X...X.X
....XX..X.....XXX.......X......XXX....X........X.....XX....X..XX.X.....X.....X....XX.....X....XX....XX...X...X
...X....X..X..X...X.....X.XXX..X...X......X........XXXXXX....X.....X...X.....X..X..X..X........X.........XX..X
.....XX.XX.X....X...XX..X.XXX....X...X.XX......XX.....X...X..........X.......X..XX.XX.X...XXXX...XXXX....X..XX
XXX..X..X......XXX...X..X...X...XX.XXX.XX..XX.....XXX...X..........XX...X....X...X....X...XXX.....X..XX..X....
..X..X....X.X..XXX.X....XXX.X...XX.....X......X............X.......X..X..XX....X.XXX....X.....X.X.X...X....X..
.....XXX..X....XXX....X.......X.....XX...X...XX...XXXXXXXX.........X...X....X.XX.....X......XXX.....X...XX...X
...X...X...X...X....X......X...XX....X..XX.X....X...........X..........X....X..XXXX..XX..X.......XXXXXXX...XXX
.........X...X......X..X.....X....XX..X..X....X..XX.......X.XXX...X........X...X....XXX..X...X.........X......
XXX...X...XX...XX...XXXX..X.....X...X.XX....X....XX.X..XX...XXX...X........X.....X..XXX....X...XX..XXX....X...
..X.....X.X....XX....X..X.....XXXX....XXXX....XX....X......XXXX.XXXX.......X...XXX..XX..XXX....XX....XXXX.....
.....X..X...X......X....XX.........X.......X.......XX...XX....X......XX......X.....XXX......X..XX.....XXXX....
...X.X..XX....XXXX...XX........XX...XX..XXXX...XXX....X.....X.X.....XXX.....XXXX...........X....X...X....XXX..
...X..XXXXXX...XXX........X.......X.XX..............X.....X.....X...X..XX.X...XX..X.XX.....X......XXXX...XXX..
....X......XXX........X...X...X........X......XXX.X....X...X.X......X...X...X...X...XX.X..XX...X.X.........XXX
....X......XXXX...X.....X..XX......X.....XXX....X....X.X.X...X...X....X.......X.XXXX...X..X..X.X......X.XX...X
.X.......XXXXX..X.X..X...X.....X...XXXX....XXX....XX.....X..XX.....X...XX.....X....X.XXX....XX....XXX.X.X.....
...X...X.X...X....X....X.....X.X..XXX...XX..XX.XX...X.X...XXXX..XX...X..X..X..X..X.......XXX..X.........X.X.X.
..XX...X...X...X....XXXXXX...X..X...X....XX....XXXX.X...X...XX..XXX..XX..X..XXX.....X.....X...X...XXXX......X.
.....X.X..X......XXXX.........X.X........XX..X........XXXXX..X....X.XX...XX.....X.....XXX...X..XX..XXXXX...XX.
...X...X....X...XXX.....X...X...X....X...........X.......X...X....X....X..X........XX....X..XX...X.......X....
.X.......X....X.....XX....X....XX....X....XXX....X.....X...XXXXXXX........X.....XX..X............XX....X......
.........X...X..XX.....XX...XX.....XXXX...XXXXX..X......X...X......XXXX...X..X....X.....X....XXX.....X....X...
X.XX.....X.....XXX...............X............X....XXXX.X.X......XX.....X....X.X.....X.....X.....X.X.XXXX.....
X....XX....XX......X...X...XXXX..X....XX.X......XX...XX........X....X......X.....X.....XXX.X....XX.....XXX....
......X.......X......X...X.......XXXX.XX...X.X...X.....X........XXXX...X...........XX....X...X.....XX....X....
.XXXX.X..........XX...XX.XX...XX...XX......X.X.X....X....X....X......X.X.XXXX..XX.....XX..X....X.X.XX......X..
...XX...X......X...XX..X....X...XX.....XXX...X.XX.X...X....XX.XXXXX..X.........X..X...XXX........X..X...XX.XXX
XX.X......XX....XX.....XXXX..XX......X......XX.XX.......XXXXX..XXX......X........XX..XXX...X......X...X....XXX
X..X.X.......XX.XX......XX.......XXX.X....X....XXX...........X..XX....X...X.......XX.....X.....XX..X......XXXX
..X.......X..XX.......X....X...X...X...X....X..XX............XX.....X.......X.....XXXXX............X.X.XX.....
....X.......XX....X...XXX..X.X...X....XX.X...XXX..XXX....X...XXXX........X....X..X......X.....X...X..X..X..XX.
XX.......X...X.XX.....X....X..XX....XX.....X.XXX...XX..X...X......XX.......X.....X..X..XXXX...X.X...XXX....X..
X..X.......X.X..X..X..X....XX...XXXX...............XXX....X......XXXXXXXX....X...XX.X.......X.X.XX..XX...X...X
..XX......X..XX..X...X......XXX.............X...XXX.....X.X.XX......XXXXX......X..X...X...X.X...X....X.XXX.XXX
........XXX.XX...XXX.X........X.....X...X..XX.X...X...X.....X..XX.X.......X.X.....XX....X...XX..X.XX...XXX....
XXXXX..........XXX...X....XX....XXX.XXX....X......XX..XX...X..X...X..X....X.X.X....X.X..XX..X...X.....X..XX...
XXX...XX...X.....X.XXX.X..X..X......XXX..X.X.X.....X.X.....X.XX.XXX.....XXX.X....X......X.....X.....X....X....
..X.X.XX.X....XX....X..X.XX........XXXX..X...XXXXX.....XXX...XX.....X.X...X....X.XX.X...X........XX......X.X..
..X.X....X..X..XX.X.X.......X.X......XX...XXXXX.....X...XX...X...X..X.X......X...XX.....XXXXXX......XX...X...X
..X.X........X..X.......XXX...X.X....XX.X.....X.X.....X........X...X..X..............X..X.....XXXX.....X.XXX..
....X......X.XX....X.....XXXXXX...X.....X..XX...X..X........X........XX.XXXXXXX...XX.XXX..XXX...X..X...X..XXX.
.XX..X.......XXX.......X...X...X....XXXXX..XXX...X...XX.......X...XX..X......X..XX...XXX...XX.....X.....X...X.
..X..X...XX...X............X.X...X...XXXX......X....X.........X.......X..XX..X.XX..XXXXXXX..X....XX.X.X.XXX.X.
X....XXX......X.X.....X......X..X....XXXX......XXXX....XXXX...X.....X..X....XX.XX.X...XXX...X..X......X.XX..X.
..XX..XX..X.......X.X....XX..X....XXXXXXX..X...XXX...X..X.......X.X..X...X...X......X...X....X.....X....XX....
....X.XXXXX..X......X..X...XX..XXXXX...XXX.......X.X..X....X....X..X..X....X.....X......X..X....XX...X..X..X..
......X..XXX...X..............X......X.X......XX...XX....X.X.......XX...X.....XX...X....X...XXX..XX..XXXX....X
.........X........XXXXX...XXX........X.X.XX...XXX...X..XX......X..............XX.....X..X.X...XX.XX.XXXX..XX.X
......XX......XX....XX..XX.....X.....X.....XX..XX.X....XX.X....X...X.....XX.......XX.X....X....X......X..X...X
...XX..XX...X....X...X......XX....X........XXX..X.XXXX....XXXX.......X.XXX..X..XX..X.X.......X........X.....XX
.XXXXX...XX.X...XX.X......X.....X.XXX...........X..X...XXXXXXXX...X....X...XX....X.........XXXXXX......XX.X..X
..........X.X...X..XX......X..X...XXX...X........X...X.....XXXX.X...X......X..X.....X.XXXXX..........X....XX..
XXXXX...X...X.....XX..XXXX....X.....X.X......XXX..X..X..........X..XXXXXX....XX.X.X...XXXXX......X....X.....X.
XX....XXXX.....X.....XX..X..X.........X..XXX..XXX....X....X......X.....XXXX.X.....XXXX....X..X.....XX....XX...
XX...........X...........X..XX.....X.....XXXX...XX...X..X........XX......XX....X....XX....XXX......XXX.X.....X
XX..XX....X.....X...X....X...X...X...X...XX........X..XXX..XXX........X......X....X.XXX...X...X......X..X....X
....X...X.X.......X.X.X....X.....X...X...X.....XX..XX..XXXXX...XXX.XX...XXXX.XX.X.X.....X.......X.XX....X.X..X
..X...X...X....X..X.....X.....X..........X.X......XXXX..XX......XX..X.....XX....X...XX....XX....X..XX.......XX
X...XXXX..X.XX......XX......X...X.....X....XXXXX...XX...X..XX.X.....X.....XXX..XXX.....X...........XX....X....
XXX...X.....XX..X...X..X.X..XX..XXX...X.X..XXX...X....X...XXX....X...XXXXX.....X...X.....X..........XXXX.X.XX.
........XX...X..X..XX......XXXXXXXX...X.....XX......X...XX..XXXX...X.X.....XXX...XX...X..X...X...XX...XX...X..
..XX.....X.X.X...X......X...........X.......X.....XX....XX........XX........XXX..X..X......X...X....X...X....X
X...X..X.....X.X..XX........X....X.....X...X..XX.....X..XX...XXX......X...X.....XX........XX..XX..X...X.X.XXXX
....X....XX....XX.....XX..X....X...X.X...X.X.X...XX..X.....XXXX..X......X....XX...XXXX..X......X...XX.X.X.....
.X....X..XXXX.....X.X........X....XX..XX...X.X...X..X..X........XX...X..XX...XX......X.......X...X......XX....
...XXX..XXXXXXX.....XX...XXX..XX..X...X....X.....X..X.....XXXX.....X....XX.......X.....X........X....XXXXX.X..
.......X......X..X.....X.XX...XX.XX.XX..X.....X..X....X.X......X.XX...X.XXXXXX...X..X....XX...X.X.....XX......
.XX...XX.X....X......XXX.X..X.......X..XX...X..XX..XX...XXXXXX...X..X.......XX....X...X...XXX.X.X...X....XX.X.
.X..X.XX.....XX...X..XX..X......X.....XXX....X....X....X...XXX.....X...X..........XX....X.....X...X...X..XX...
...X..X...XX.X..XXX.X...X....XX.XXXX..X......X..XX...X...X.X......XX.....X.X...XX....X.....XXXX..XXX.......X..
.....XX........X......X...XXX...X..X....XXXXXXXXX..X.X..XX...XX.X......XXX...X....X......X....XX..XX.X........
...XXXX...X........X..........XXX..XXX.XX...XXX...X..XX...X.....XX........X...........XXX..XX.X...XX.XXXX.....
....X...X...XXXXX...XX.XXXXX..XXX...XX....X.XX....X...XX....X......XXXX.X...X......XXX....XXX...X..X.XXXXXXXXX
..X.X.XXX....XX...X..X..XXX...XX..X.......X.X..X..XXX.X..X....XXX..XXX..XX....XX...XX..X..X.....XX...XXXXXXXXX
XXX...XXX..X....XXXX....XXX...XX..........X...XX..XXX...XXXX..XXX..XXX.....X..XXXX....XX..X.....XXX..XXXXXXXXX
