36 37
....X......X...XXX..XXX...X.......X..
.XX......X...X..X...X...X....XXXX....
.....X......XXX...X.....XX.X......XX.
..X..X..X.X..XXXXX...X..XX.XX.....XX.
X...XX..X..X...X...X.X.....XX..X...X.
....XX.....XX....XXX...X....XX...X.X.
.X..X..XX.....X...XX........X...XX.X.
.X..X.......XXXXX..X..XXX...X.X.XX...
.X.......XX....X...XXXXXX.X...X.....X
...X.XX...XXXX...X....X...XX......X..
XX.X....X..XXXXXXX.XX.....X....X.....
XX.........X.....X.....X..X.XXX..X...
XXX..XX..XXX.....XX....X..X.....XX...
.....X...XXXX....X..X..XXX...........
...X...X.XX...XX...XXXXXX..XXX....X..
......XX.....XXX..X............XX....
....X......X.XXX..X.XX........XXXX...
..XXX..X...X..XX....X..XX...X....X...
...XXXXX.X..X.X..X....X...X..X.......
...XXXX.....X...X..X....X....X.XX....
XX......X....XX...XX...X.....X....XX.
XX...X.....X........XX...X...X.......
XXXX.X...X.....X.......XX....X.XXX...
.......X....XX.....XX..XX......XX..X.
....X...........X..X..XX....X.....X..
..X..XX.......X.X..X.X...XX...X..XX.X
..XX...XX...X.X.XX...X....XX..XX..X..
....XX...XX.....X.........X..XXXX....
.XX.X......X......X...XX....XXXXX....
....X.X.X........X..X....X....XXX....
........X.X.X......XX.X....X......XX.
..XX......X.....X.......X....XX...XX.
X......X.....XX..XXX....X...XXX.XXX..
...XXX...XXXXXXX.....X....X.....XX..X
.X..XX.....XXXXX..XX.X........XXXX...
....XX.....XXXXX..XX.......XX........
