17 18
.....X............
.XX..X......XX..X.
....XXX.........X.
XX......XX...XX.X.
X..XX.........X...
X.X....X....X....X
X......X.X..XX....
.......X...XX...X.
.X...X....XX..X...
.X.X......X..X....
.X.XX.....X.XX....
.X...XX...X.....XX
......X...X..XX...
X...X.X...XX..XXX.
..X.X.....X...X...
....X..X....X.....
.........X..XXXX..
