112 112
.....XXXXXXX...X........XX......XXX...XXXXXXXX..X....X.....XXX........X...X....X.....................XX.........
.......XXXX..X...XX........X....XXX.......XXXX....XX...X.....X.X......X.X...X..X.....XX......X...XXX....XXXX....
...XX...XXX...X.....XX........XXXXX..X.XX...XX...XXXXXX........X...X....XX....XX...X......XX.X.X.X....XX...X...X
.X..X.X....XX...X..XXX..XXX.X.....X....XX......X........X...X.......XX.X...X.....X.....XX..X.....X.......X.....X
.XX...XX........X...XXXXXX..XXXXX.X...X...........X...XX......X...X.XX.....X........XXXXXX....X......XX..X..X...
.XX..XXX..X.XXX.X.X.....XX........X..........XX.X.X.X..X...X..X.XXX...X....X......X..XX...X.......X..X..XX....X.
...XXXXXX.X..XX.X....X..X...X....X...X...X....X.X...XX....X...X...XX....X..X...XX..X....X...XX.X..XXXX.....X....
XX...........XX....X...X..X...XX...X...X....X...X....X..X...X.....X..X.....X....XX.XXX..XX..X..X.XX....XXX...X..
XX.......X.X...........X.....XXX..XXX..X..X.......XX.XXX...XX.......XX...X......XX.XX..XXX....XX....X...XX..X...
...XX....X..........X......XXXXX..XXX.XX.......X..X..X...X......XX.....XX...XXX....XX....X.....XXXXXX.X.XXX...X.
......X.....X....XX...X.....X..X..X......XX..X.XXXX.......XX.X..XX...X....X.......XX..XX.X..XX.XXXX...X......XX.
.....XXXX......XX..X..XXXXX....X..X....XXXX..X..........X....X.XXX.X...XXXXXXX.......XXX...XXX..X.....XX...X.XX.
...X.XXX...X...X.....XXX.......X.....X.......XXX..X...XXX..X.......X....X...XX...XXXXXX....X..X....X..X..X.X....
.X.....X.X.XXX...X..XXXX.......X.XXX......XX......X.X.XXXX...XX.XXX...X...X....X........X..X.....X...XX........X
....X....X.XXXX.......X.....XX...X......X.......X.....X......X..X...X....XX..XXX........X....XXXXXX..X..X...X..X
X.X.X.XX.....X..X..X....XXX....XX..XXX...X......XX...XX..XX..X....XX...X..XXX..XX..X....X...........XX....X...XX
..X...X...X....X...X.X.......X..X.XXXX.X....XX..XXXX...X....X......X......X....XX..X.X..X.......XXXX...XX....XXX
.....X..X...X.XX.X.........XXXX.X..X......X.XX..XXX..X....X...X..X.XXXX...X.XX.XX..X...XX...XXX......XXX...X....
XX...X.XX..XX.......X......XXXX....X.XX........XXXX.....X....XX..X...X....X.XX.....XXX....XXXX...XXX.....X.XXX..
XX.....XX.....X..........X.......X...........X....X...X.XX...X...XX....X....XX..XX...X.....X...X......X..X.....X
X...X...X...X..XX...XX...X....XX....X........XXXX...XXX....X...X....X.XX.XXXXX.......X...X..........X...X...XXXX
..X...X.X.XXXX....X.XX..XX.XX...XXX......X......XX...XX..XXX.XX.......XX.......XX....X....X...X..X........X.....
.XX..XX.X..XXX..XXX..X...X.XX....X.....X.XXXXXX....X.XX......X..XXX....XX..XX..XX..X....X...X....X...X.....XX...
.X....X....XXX...XXX.X.X...XX..X...XXX......XX....X..X..X...XX......XX.....X...XXX....X..X..XX...X......XX.X....
.X..X....X.....X.X...X.X....X...XX...X.XX...XX......XX.X..X.......XXX......X.X..X...X....X.XXXXX......X....X.X..
..X.XX.......XXX.......X.XX...X....X.X.....XXX..XX.....X.X..........X.XXX....XX...X....XXX...X..X.....X..XXX.XXX
X...X...X.....X...X.X...........X..X.XX......X......X..X.X.X.....X..X.X...X....X...X...XXXXX.X..XXX...X....X....
XX..X.X.X...X...X.X...X...XXXXX...X..X..X.XX.X...XX.X..X.....XXX.X..X.....X......X...X.......X....X......X..X...
X...X.X.....XX..........XX........X.X..XX..X...X..........XX.....X.....X..X.....XX..XX....X..X.XX...XX.X..X.X.XX
X...X....XX....X...X.........X......X.XX...XX....X...XXX........XX...X......X....XX.....X.XXXX.XX......XX...X.XX
....XX......X..X.X......X.X..XXX...X.....XXXX.X....X.....XX...X..X...X.........X....XXX......X.XX.......X.......
....X....X..X..X....X.....X.XXX..X...X.....XX..XX.....X.......XX...X......XX.X.........X.XXX.X..........X....X..
..XXX.XX....X.......X..X....X...X..........XXX....XXX...X.........X..XX.X..X..X......X.X.........X....XXXX...X.X
......XXX.......XX...X.XXX..X.X...X...XXXXXXXXX....XXX........X.X...XX..XX....X.XXXX...X...XX.......X......X.X..
...X......XX.XXX...X.....X..X.......X....XX......X.X...X.XX...X........X............X....X.X......X....XX..X..X.
.XX..X...XXX...X...XX........X...X....XX.....X.X.X.......X.........XXX.....XXX.X......X......X.....X...XX.....X.
....X..X.....X.....X....X........X.X.......X.X...XX...X....X...........XX......X.X...XX.X.X.....XX.X..X..XX.....
XX....X...XX.XX....X.X..X.X..........X.......XX..X....X...X..X...XX..XX...X........X......X...X....XX.X...X.....
XX......X..X...XX..X.X....X.......X....XXXX..XXXX..XXXXX..X....X.XX.....X...XXXXX.....XX...X..XX...XX...X...X...
...XXX.....XX.....XX.....XX.XXX...........X....XX...XX...X..XX......X...X........XX.X.XXXX....X..X..X..XXXX.....
.X.....X......X.X.X...X...X.X...XX......X.XXX.....X........X....X.....X....X.....X..X.......X...X...X..X....XX..
.XXX.......X....X...X...X.X.....X.....X.X..X..X.....X...X.......X.XX.....X......XX.XXX............XXXXX..X..XXXX
..X..XX.XX...X.....XXX......XX....X.....XX.X.....X....X.....X...X.X..X...XX...X..X.....XXXXX.....X......XXXXXXXX
X...X...XX.....X.......XXX...XXX.XX..X...X.....X...X.....X..........X....XX...XX....X.....X...XX.......X........
..XX..X..X........X...XXX..X...X.XXX...X..X.....XXXX.X.....X.....X....X..X..X..X..X.X.X.....X.X.....XX...X......
...X.XX..X......X...X..X..XX...X...XXX....X.XXX...XX...XX.....X....X..XXX..X...X....X...........X....X..XX..XXXX
.X.X.....X...........X...X.......X......X.....XXX..X......XXX...X....XXX..XX.X...X.....X..XX...XX....X..XXX.....
.....X...X......XXXX..X.......X.......X..........X.X..X........X..X...XX...X....XX...X.X.....XXXXX...XXXXXXX..X.
..X...XX....XX....X...X.X.....X.X.XXXX.........X...X.........X...XX.X....X.XX...X..X.....X.........X..X..X....X.
....X.....X....X....XX....X.XXX...X....X.......XXXXX...X............X..X...XX..XX.......XX.X......XXX....X.XX.X.
...XXX......X....X...X.X..X..X......X........XX...XX.....XX.X...XXX....X....XX.....XX.XX...X.X...........X.XX...
...XX..XX..XX...X..X......XX.X...X....X......X..X....XX...X...X..X.....X.XX...XXXX.XX........X..XX.......X...XXX
.X....XXX..X..X...X...X......X.....X.....X...X.X..X..X..X.XX...X...X.X......X..XXX........X...X....XXXXX..XX....
...X....X..X...X..X........X....XX.X...X.XXX.........X.X.....X.XXXXX......X....XXXX.....X...X.XX...XXXXXX..XX...
X....XX.X....X.X.....XXX.........X...X........X....X.X...X.....XXX..X...XX...XX...X...X....XX....XXXX..XXX.XX...
..X...X.X...XX...XXX.....XX......XX.....X...X....X...XX..XXXX..XXX..X......X..X.X.X......X......XX..X...XX.X....
......X...XX......X...XX......X..XX..XX...X....X.....X...XX.....XX....X...XXX.....X..X...X..XXX.XX....X..X.X.X..
...XXXX..X......X...X..XXXXXX....XXX..XX.....X.XXXX..X.X....X......XX.X.X.XX.....XXXXX.X....XXX.XX...XXX...X..XX
....XXXXXX..X...XX..XX...X....XX.XXXX....X.....XX....X....X...XX.XX...X....X.XXXXX.......XX.....X..XX...XX..X...
..X.XXX.....X.XXX...X..X...X..XX.X.....X...X..XXX....XX.X...XXX..X.......X.X.XXXXX..XXX...X..XXX..XXX.X.XX..XX..
....X...XXX...XXX.X.X........XXX.....X..X..X.......XX...X..XX...XX.X...X.....XXXXXX.....X.X......XXX..X.....XX.X
...............XX.X...X......XX.........X.X..XX....XX.XXXX..X.XXX....X....X...XX...XX.......XX...XX..XX...X.....
XXXX...XX..XXX.X..X..XX.XXX.....XX..XX..X...X...X.....XXXXX...X...X.....X...X..X.X....XX.X.....X....XXX.X.....X.
XXX....X...X.....XX...X...X......XX.....X..XX...XXX....XXX.......XXXX.X.XX..XX.....X..XX......XXX..XX...XXX...X.
XX..X....X...XX.....X..XX........XX.XXX..XXX....XXXXXX.....XXX.X.XX...X.....X...XX...X....XXX..XX..XX.X.....X.X.
X..X..XXXXX.........XX.X...XX..........X.....X....X........XXX.X.X..XX...XX...X...X..X.....XXX.XX...X.X..XXXX...
X....XXX....XXXX.......X.X.......X...X...XX....X....XX.......X...X...X.X..X..X..X...X......X......X.X..X.X....XX
.......X.....XXX..XX.........X.......X....X......X...X....X....XX..X...XX.X..X.XXX....XX........XXX....X...XX...
.............XXXX.......X.XXXX..X....X..X...X......X......X.XX..X....XXXX....X.XX....XXX....X....XX..XXXXXXX....
......X.........XX...X..X..XXXX....X.XX.......XXX.....X..X..XXX...X....X...X...XX.XXXX....X....X....XX...XX..X..
.............XX....X...X...XXXXXX..X.....X.X..X...X...X....X.....XX.X....X....X...XXXX....XX...X.......X....XX..
.....X.XXXX..X..X..XX..X....X.....X....X.X.X.XX.X...XXX...XX.X....X...X.....X...XXX.....X......X...XX..XXX......
...X...X....XX......X....XX.......X.X......X.X..X...XXX...XX.XXXX.X..XX.X......XX.....X...XXX..XX..XXXXXXXXX..X.
.XXXX..X...XXX...X....X......X....X...X...XX...X......X......XXX..XXX.....XX.......X..........X...XXXX......X...
.......X.....X.XXX.X....X......X..XX..X...X...XX.X....XXXXX....X...XX..X...X.......X.X.....XX..........X....XX..
X..X...X.......X...X...X..XXX..X..X..X..X...X..X...X..XXX...X..XXX.XXX...X...XXXX....X...X.....X...XXXXX...XX...
X....X......XXXX..X..X...XXXXXX..XX....XX.XX...XXX.X...X..X...XXXX......XX....X.....XX.X.XXXXX.X......XX...X..X.
..XX....X.......X.X....XX.....X.....X...X....XXXXX...X...X..........X...X..XX....X.....X.X.....XXXXXX..X.....XX.
...XXXX.........X...X.....X...X...X...X.XX....XXXXX...X....X.X....X.....X.XXXXXX...X.X...X..XXXX..XX...X.....X..
XX...XX..XXXXXX..X..XXX.X...XX..XX....X.X..XX..XX...X...X....X.XX.X..XXXX......X..XX.....XX....X.....XXXX......X
.....XX...XX.....X.XXX..X..XXX.....X..X...X..X.X........XXX....XX.XXX....X.....X....X....XX..X.X...XXXXX..XXX...
.X....X.X....X...X...X...X.X..............X..X...X...XX...XXX..XX...X....X....X..XX...X...X..X...X...X...XXX....
...XX............XX..XXX.X...XX.....X.....X...X..X...XX.....X..X..X.XX...X..X.X.........X.X...X....X...XX....XXX
X........X....XXXXX.XX...X..X...XXX.....XX..X.X....X.....XX.X..X....X..X.XXXX..XXX...X....X...X...XXX..X..XX....
..X.XXXX...XX..XXX..X..X..X........X.......XX...XX.XXX...XX......XXX..X..X..XX.....XXX...X..XXX.......XX...X....
....X.....X....X...XX.X...X..X.XXX.XXX......X..X...XX..X.XX..X.....X.XX.....XXX....XXXXX.X....X..X......XX..X...
......X.X.X...........X.X..X.X..X..XX..XXXX..X.....XX....X.....XXX........X..XX.XX.XX......XX...XX...X....X...X.
XXXX....X......XX...X....X...XX...XXX...XXXX...XX.....X....XX.........X...XX....XX.X..X.....X......X...X........
XXX..X.....XXX.X..X....X.XX..XXX..XXX.X...XXX.....X.....X..XXXX.XX....X.XXXXXX..XX...X......X..XX.....XX.X.....X
XXX......X.X.....XX..X...XXXXXX...XXX.X.....X.X...XXXX.......XX....XX.....XX....X....X.XXXXXX..X..X.X..X.....X..
..X...X..X....X....X....X..XXXX.X...X....X....X........X......XXX......X.....X..X....X...XXXXXXX.XX..X.X..XX..X.
..X.....X...X....X....X.X....XX.X......XXX.X.X............X.X...X...XXXX.X.XXX.X.....XXX.XXX...X...X........X...
....XX....X....X......X...X.....X..XXXXXXX...X.X......X.X...XXX...X..XXX...XXX.X.XXX.X...X...X.XX..X..X.XX.....X
.XX....XXXX.XX....XX..XX....X.X.....XXXXXXXX.......X..X.X..X.......X..XX....XX.X..XX...X...XXX....XX....X..X.X..
.XX..X..XXX.....X..........XX.....X....X......X......XX.X....X...X....XX.XX.......XX..XX..X...XXXXXX......XX..X.
.XX.....X.........X.....X....X.XX.X....X..X.X.....X...X...X...XX.X..XX...XX..XX.....X..XX...X........X...XXXX...
......X........X..X...X.X.X..X......X..XX.X..X......X.......X....X...X.XXXX....XXXX....XXX...X.........X........
XX.X.....X........XXX.....X.X....XXXX..XX.XX....XX.....XXXX....X...X......X.......XX...X...X.X.XXXX...XX..XX....
XX.X.X.......XX...XX...XXXX...X........XX.X...X....X.....X...X....XXX.....X...X........X...X.....X....XXX....X..
XX.X...XX.X..X....XX.....XX..........X......XXX....XXXXX...X....X...X....X..XXX.XX............XX...X..XXX...XX..
...X......X.X..XX....XXX.XX....XX......X...X......XX..X...X...X..X..XXX..X...XX.XXXXXXX...XX..X...XXXXXXXXX.X...
.XXX........X...X..X...X..X.......X.XX...X...XXX...X....X...X..X...XXXX......XX......XX...XX..X.X..XXX........X.
..XX.....X......X...XX....X.......X...........X..X...XX....XXX..........X...XXXXXXX.......XX..X....XXX..XXXX....
X.....XX.....X....X..X.....XXXX.......X.XX......XXX.............XX..XX....X.X.......X.........X..XXX..X.XXXXXX..
...XX.....X.....XX...X.XXX...X.....XX.X..X...X........XX......XXXXX....X....X..XXX....XXXXXXX....XXX..X.........
.X....X.....X.X..X.....X..XX...X.XX......XXX....XX.X..XX.X.....XX......XXX...X...X.XX...XXXX..XX......XXXXX...X.
.X....XXXX....XX....XXXX.......X.....X....XXX...X..X.X...X.XXX.X...X.....XXX.......X......XX..X.......XXX...X.X.
.X...XX...XX...XX...XX...XXX.......X.XXXX.X.....X......X...X...X.X.X..XX.XXXX........X.....X....X...........X.X.
.X....X.X...XX......XX....XX.XX......XXXX.X..X......X......X.XXX.X....XX....XXX...X..X...X...XX.....XXXX....X.X.
.X..X...XXX.........X..XX............X..X..X..XX.XX.....X..X..XX...XX..XX...XX..X...X..XXXX......XX...X.....X...
.....X...XX..X......X.......XX.......X.....XX....XX..XX....XX.X........X....X..XXXX...X.....XX...XXX....XXX.XX..
XXXX...X.......XXX..X..........XXXX..X.....................XX...X........X..X...........XX..XXXX.....X......XX..
