103 105
....X..X......X......X....X...XXXX.......X...X...XXX........X....X...XX...XXXX....X.......X.....XXXXXXX..
.XX....X.XXXX...XXXX.X..X...X........XXX...X...X.X...X....X.X..X...X....X..X....X....XXXX...XXX.XX.......
.X...X..........X..X..X.XX.....XX.XX......XXX..X.X.XXX.XX...XX.......X..XX....X..X.X....XX..XXX....XXX...
...X....X.XXXXX.......X.XXXX.X..X..XX.....XXX..X.X.....XXX..X...XX......X.....XX.X..X...XX...........X...
XXXXX...X...XXXX...........X.XX.XX..X.XX..XX.....XXX....X...X.X.......X...XX........X.XX..........X......
..........X.XX......XX.X...X........X...XX...XXXXX...XX...X.X...X...XXX..X.....XX.....X..XX....XX...X....
.XXXXX....X.......X.X..X.....X.......XX..X.....X.....XXXXX..XXX.XXX..XXXX...XX...X...XX......X....XX.....
.......X...XXXX...X...X.........XXXX.XXX.XX..X.............XX.....XX.XX...X......X.X..X....XXXX...X..XXXX
X........X...XXXX....XX.X.....X.X....X....X.....X...X......X...XX.XX..........X....XX...X..X....XXX...XXX
X...X.....X......X....X...X.X.....XX....X...XX..XXX...X..X...X.......X...X..X...X....XXX...X.X......X.X..
XXX.....X.X.X.XX......XX..X....XX....XX....X...X..XXXXX...X......X.....X....XX....XX.....X...X...X..X....
.....XX.X.....X........X.XXXXX..X.X..X...XXX..XX........X...X.X....XX....XX..X.XXXXXXXX......X.XXX.X.....
.XXX.......XXXX........X.X....X......X.X..XXX....X............X.X..X..X......X......X...X......X...X.....
....XX...XXXXXXX.......X.X....XX...X.X....XXX.........XXXX.XX......X....X.XX..X.....X.X....XX..........X.
X...XX....XXX........X...X...XXXXX.....XX.X...XXX.X...XXX..XX..X...XXX....XX..X.XX....XX...X........X....
X.XX......XXX.X.X....XX....X.X...XXXX...X.........X.XXXXX...XX...XXXX..X......X..X........XX........X.X.X
X....X....X.....X.X.....X....X.X...X..X........XX.........X.........X....XXXX..X...XXXX.X......XXXX.....X
XXXX...XX....X....XXX.....X....XXX...XX..X...........X.......XX...X.XXX......X.XXX..XX..XX...X.XXXXX.....
.......X...X.XXXXXXXXXXX..XXX....XX...X..X..XXXX.....X...X.X.XX...X.....XXXX.X...XX....X...X.........XXX.
....X....X............XX.....XXX..X.X..XXXX........XXXX....X..X...X......XXX.....XX..XX..XX............X.
X...XXX.....X............X...XXXX...XX..XXXXX...........X...X...X.....XX......X...XXX...XX..XX....X......
..XX..XXXXX........X...X...XX..X........X..XX.........XX....X.....XX........X...X.X.....XX......X..XX...X
.XXX.........X.......X...XXXX..X.X.........XX..XXX....X..XX........X...X.....X..X....X....XXX...XX....X..
..X..XXXXXX.......X..............X......XX.XXX.....XXXX......XXXXX...X...X.X.X..XX.X.........XX..........
X.X.....X.......X.....X...XX..XX..XX.......X...XX..XX..XXXXX..XXXXX......X.........X..X..X...XX....XXXXX.
..X...X....X....XX......XXX...X...XX.XXX..........XXX...XXXXX.XXX...XXX.......X.......XXXX..XXX.XX...XX..
.XX.X.X..X......XX...X......X...X....XX.......XX......X....X..X.......XXX........XX...X..XX.....XXX.....X
.X..X.X.....X.XXX........X........X..XX..........X.XXXXXXX...X.....X..X....XXX.X....X....XX..XX...X.X....
.X.XX.X...X...X...X...XX.XXX.XX....XXX..XX....X..X..XXX..X.....X...X.XX....XX..X..X..X...XX.....X...XXXX.
.X......X....XX...X........X..X..X...X.....XX.X.....X....X.XXXXXXX.......XXXX.....XX...X..X....XXX..XXXX.
.....X.....X......X.....X.....XX..XX...XX.....XXX.....XX...X.....XX.X.....X.....X......XX.X..X.XX....X...
..XXX..X.X.....X....XXX...X.XXX...XX....X...XXXX........X....XX..X..X.X.X...XX.....XX.....XXXX.XX.XX...XX
XXX...XX.......X.XX.......X.....X.......X........XXXXX....XXXXX.X..XX.X........X.X.XX......X......XX..X..
........X....XX..XX..X..............X......XX...X...X..X....X...X...........X..X.........X....X...XX.....
...X..........X...XX...X...XXXX..X....XX......X...X...XXXXX....XXXXX........X.....XXX.........X.X....X...
X....X......X.XXX........X.......X...XXXXX...XXX........X....X.......X...X......XX......X.....X.......XX.
..X......XX.X.....X...XX.XXXXXXX......XXX..X.XXXXX........X...X........X.X...X.....X.XX.....X....XX...XX.
.X..X....X..XX......X..X............X...X.XX...XXXXXXX......X...XXX...XX.XXX....X....XXX..X.XX...XX..X...
.X.....XXX...X..XX.....XXXX...XXXXX.......XXXX......XXXXXX..XX......XXXX....X.X.XXX.......X.XXXX..XX.X.XX
...X.X.......XX.XX...XXXXXX.X....XX....XXX...XX.......XX...XX..X...XXXXXXX..X.X...........X.X...X......XX
.....XXX...XX......XXX........XX.XX..XXX...X...........X.X....XX.X...X.....XX.XX..........X.X.X.....XX..X
.........X.....X.....X.....X.....X...X.......XXX.....X...X..X........X.XX.....XX...XXXX...X.X..XXXXXXX..X
....XXX.....XX...XXX.XXXXX...X.....X.X.XX.....X..X......XX......X.XXX..XX.XX...XX.......X...XX...X......X
X.......XX....X....X........XX.XX..X.X.X....X.......X.X..X...XX.X.X...XXX....X....X.X......XX..X......X..
X.XX.......X....XX.....XXXX....XX..X...X.X..XX....X.X....X......X.....XX.......X..X...XX.X..X.....X...XX.
X..X......XX.....X..XX..X...XXX...XXX..X.XXXXX....X....X....XX..XX....XX.XXXXX.X.......X..X...XX....XXX..
XX...X......XXXX.X..XXX...X.....X.X....X.XXX......X..X....X.X...XX....XX.X.......X...X....X......X...X..X
XXX....X.....XXX......X......X......XX.X.....XX....X....XXX.......XX..XX....X...XX.X....X...XXX....X.X...
......XXXX.X......XXX...XX...X...X...X.XXXXXXXXXXX....X..XXX...X.....XX...X.....X.....XX.......XX....XXX.
........X..X..XX..XXXX..XX....X....X................X....X.....X...X.X..XXX..X....X......X.XX..XXXX..X...
X....XX...XX..XX.XXXX...X.....X.X.....X.......X...X......X..X....XXX...X.....X..XXXXXXX..X....XXXX...X.XX
X....XXX...........XX.X...XXXXX.X........XXXX...X....XX..XX.X.....X........X..X.XXXXXX.....X....X..X.X...
X..XX....X..XXX.XX....XXXXXX...........X.X...X..XX.......XX.......X..XX.X.....X.....X..X.....X....X....X.
...XX...XX..XXX.XXX....XXX.....X.XXXXX.....X....X......X...XXX....XX..X...X....XXX....XX..X..X.X....X....
.X...XX.XX...XX.....XX......XX.X........XX....X...XXX......X...XX.XXX.XX.......XXX.X....X.X....X......XXX
.XXX.X.....X..X...XXX.....X...........X....XX.X.......X.X.....XXX.....XX...X..........X.....X...X....X..X
...X...X.XXXX...X.X...X......XX.......XXXXXXX.........X.X.X.X.......XXXX...X......X.X.XX...XX.X....X....X
....X..X.....XX.....XXX.XX.X.XX....X..XXXX...X...X....X...X..X..X.....X..X..XXX.....X....X....XX...X.XX.X
..X...XXXXXX.....X.XXXX....X....XX.X..XXXX.....X...X.......X....X.XX..X...X...X..X.....X....XXXXXX......X
XXX......X.....X...X..X..XXXXX.......XXXXX..X......X...XXX......X..X....X.....XX...X......X....X....X....
.......X.X........X...XXX..............XXX...XXXX....XXXXX......XX.X...........XX....XX...XX.....X..XXXX.
.XXX.XXX........XXX.X..XX..XX.X............X......X.XXX.......X....XXXXXXXXXXX.XX.X.......XX....X..XX..X.
.XX..XXX..XXXXX.....XX...X.XX...X.....X.....X.......XXX.X...X...X..XX..XX..XXX....X...XX......X...XXX....
....XXXXX.....X....XX..X.....XXXX...XXX...X...XX.X..X.....XXX.......X...X......X....X.......X.....XX..XXX
XXXXX.........XX....X.....X...X...X..XXXX.XX..X..X..X..X...X........X.X...X....XXX....X.XX..XXXX.....X...
.......X.X....X...X.X...X...X...X....X.....XXXX.....XX...X...X.....XX..XX.....XXX.....X.XX.XXX...X.....X.
...X.X.X......X.X...X......XX..XX..X...X.X........X..........X...X.X...XX..XX...X.X...X....X...X....X..X.
XX.X......X...X..X.......XXXX...XXXX...X....XXX...XX..X........X.....XXX........X....X.....X.X....X.X..X.
XX.XX.X...X...XX.....XXX......X.XXXX....X.XXXXX..XXX...XXXXXX.......X....X..XX.....X...X...X....X...X..X.
...XX.....XXX.....X..X.....XXXX.......X.X....XXX..XX.X.........XX.....X..X..XX......XXXX.XXXXXX....X.....
..XXXX....XXXXXXX..XX.........X.....X......X.X..X....XX...............X..X.......XX..XXX......XX.X...XXXX
X...X..X..X.....XX..X.X.....X...XXX....X...X....XX...XX.........XXXX....X..XXX.....X..XXX.....X..X....X..
XX..X.....X.XXX...X.......XXXXX...XX...X.XX..XX..X.X.XXXXX...........X....XXX..XX...X.X...XX..X.....X....
...XX...X...X..........XXXXXX...X.X..X...XX......X.X.XXXX..XX.......XX...X....XX..X...X.........X.X..X...
..X...XXX..XX....X......XX....XX..X.XXX..X..XXXX.....XX...XX....X...XX.......XXX.....X...X...XX.X..X.....
X.X.X..X.......X.....XX.X..X..XX....XXXXXX.XXX...XX...X...X..X.....XXX....X.....XX.....X.X.X..X.XX....XXX
X.X....X.X...X....X.....X.XX........X..X...X....XX..X.....X....X.X.X...XXXX.X.X........X...XX.X.XXX...XXX
..XX...X...X....X...X.....XX...X.........XX...X.XX.....X....X..X.X...XXXX...X.X..X..........X...XX..X.X..
.XXXXX..XX..XX.....XXXXX..X..X...X.X....X...X......XX..XXX.......X..XX......X....X..X...XXX....XXX....X..
...XXXX.....X..X.X.XXXX.....X....X............XX......XX...XXXX......X.X.......XXXX.XXX...X..X...X.......
...X....X...X.XX.X......XX....X....XX...XX.X..XX......XX.....XX....X...XXX...XXXXX..X...X.XX..X..X..XX...
.....XX.....X.XX..XX...X...X....X.....X.XX...X...XX....XXXXX.XXX....X..XX..X...X...XX.X...X...X.XX.......
..XXXX...XX...X...X..X......XX..X...X..........XX......XXX...X....X.XXXXX....X.....X..XX....X...XX...XXXX
XXXX...X........XX..XXX...X.......X......XXX..X..........X.....XX...XXXXXXX..XX......XXX.XXXXX..XX....X..
.......XXX...X.....X....X..X...X.....X.XXX..X...XX.........XX....X..XXXXX....XXXX.....XX.....XXXX...X....
....X..XXX...X..X..X.X.....X.X...X.X.X...X..X.XXXXXX....X.....X.....XXXXX.XX..XX......XXX....XXX..X..X...
..X.XXXXXX...XX...X..X.X........XX.....X....X.X......X..X.X.....X...XXXXX...X....XXXXXX...X..XXX.XXX.X...
....XXXXX....XX...X.X.....XXX.X....XX.....X.....XX...XXXX.....XX......XX..X....XX.......XXX....X...X.XXX.
.X..XXXXX...........X.X.X.....X..X....XX..XX.XX..........XXX.....XXX..XX.....XX........X....X......X..X..
.X....XXX..XXX.....XX...XX.......XXX...X.X...X..X.....X..X...X.XXX...X...XX...X.XX...X...X..X.XX....X...X
...XX...X..X...X....XX..X..XXX.XXX...X.....XX..X....X...X......X....XX......X...X..X.......XX....XX..XX..
XXXX....X....X....X.......XXXX...X......X...X.XX.XX...X...X...XX..X......X......X.XX......XX.....XXX.....
.....X....XX....X.XXX......X.....X..X.....X....X..X.XX......X.....X..XXX...X......XX....X.XX.XXX..XXXX...
.....X..........X.....XXXX....X..X.....X.....X.XX...XX.X.......XX....X.......XXX...X.........XXXX......X.
XX.....XXXX.....XXXX..XX....X.X......X.X...XX..X...X.....X...X..XX........XX....XX.......XXXXX.....X.....
X.........XXX.X..XXX..XX......X...XXX....XXXX.XX.X.X..X....XXXX.....X.....XX..X.......X........X...X..X.X
..X.....X...X....X.....X.....XX.XXX...X..........X.XX...X...XX...XX.....X........X............X..X..X.X..
.XXXX.XXX.....XX.....X...XXX....X............X.X...XXX....X..X.X..X..X....X..X...X.XXX...X....X.....X....
....X.XXX......XXXX.....XXXX......XX.X.........X..XXXX...XXX......XX.....XXXX..X...XX..X.....XX........XX
..X.X........X.XX...X...X........XXX......X.X...X.....X.....XXX.X........XXX..XX.............X...XXX....X
XXX.X....X...X....X...XXX.X...XX.XX...XX....X.X.X..XX...X.X.....X.XXX.....XX.XX...XX...XX......X....XXX..
XXX...XX.X.............X....XXX.....XXX..X....X..X...X..X.X..........XX.X..X....X.........X...XX..X.XX...
XXX..XXX.............X...X......X.......XXXX..XX...X......X......XXX....XX............XXX...XXXX..X....XX
