90 91
XX.......X...X......XXXXXX....X........XXX..XX..XXXX..X...X...XX....X.........X............
XX.........X...X..X...XXX..XX...X........X...X...XXX....X.X.X....X..X.........X.......X....
........X...XX....X.....X...X..X..XX..X....X...X...X.XXX....XXX....XX...X.....X...XXX....XX
...X.X..XXX.....X....XX.....XX...XXX....X...XX.....X.....X......X.....X...X.....X....X.X.XX
X....X.XXX....X...XX..XX...XX....X...X....X....XX...XX..X....X..X........XX....XXXX..X.....
X.X.....X..XXXX.......X..X..X.X..X.X...XXXXXX..X..X.XX....X....XX......X.....X......X...X..
X...X.X.X...XXX..X......XXX........X..........X..XX....X....X.....X......X...X.....XX.....X
XX....X.XXX...XXXX........XX...XX.....XXX.....X....XXXXX...XX...XXX..XX....X.XX.......XX..X
...X......XXX..XXXX....X..XXXX......X.....XX.....X..XXXXXX..X...XXXX....X....X..X.XX..XX...
.XX...XX.......X..X.XX.X.XXXXXXX.X..XXX..X..XX.X.XX.X....XX...XXXXX...X...X....X..X..XX..X.
.XX.X.XX.X........X.XX........X..X.XXXX..X...X......X.XX.XXXX.......X............X..XX..XX.
.XX.X..X.......XX...X...X.XX....XX....X....X....XX....XX..XXX......X...X...XXXX..X.XXX.....
..X..X....X....X..XX..X...X..X...X..X.X...XXXX.....X......XXX..X.....X.XXX...XX..X....XXX..
X....X........XX.....XXX..X.XXXX....X...X....X.......X.XXXX....X..X........X.....XX....X...
XX........XX.....XX....X..X.........X..X..XX..XX..X..X.......X..X.....XXXX.......XX..X...X.
......X.X....X......XX.X..XXXX....X..XXX.XXXX.....X.XXXXXX.X..X.XX..........X....X...X..XX.
..X.X.X....XXX...X..XX....XXXX.XX....XXX.......XX...XXX....XX...X....X....X...XX...X....XX.
X.X......XXXXXX..X.....XX..X...XXXXX..XXXXX......X....X...........X....XX.........X...X....
X....XXXX.......X..X.X..XX.....XXXX...X.....X......XX.XXXXXX..XX....XXXXXX...X..X.X.....X..
...XXX..X....X..X....XX.X......X..X.......XXXXX.......XX...X.....XXX.....X.X....X.XXXX..X..
.X......XX.....XXXX.....X......X..XXXX......XXX..XXX..X..X.....XXX...XXX.X....X.X.XXXX.....
........XX..XX.XX.....X..XXXX..X..XX.....X....X....X..X.XX..XXX.....XXXX....X.X.X.XXX..X.X.
..XX...XXX..XX..X........XXX...X...X.XXXXX.X....X.....X...XXX...X.X......XX.X.X...XXX..X...
X....X......XXX.....XX...XXX.X...X...XXXXX...XX...X.X.XXX...X..X..X..X...X..X.XXXX..X......
..X..X....X...X..X..X....X...XXX........XXXX.....X..X..X....XX.X...XXX..X..XX.........X....
.XX....XX...X.XXX..XX....X..............X....X.X.X.XXX...X...X.XXX...XX.X....XX....XX.....X
....X.X.....X.....XXXXXX...XX..XX.XXXXXXX...XX...X..XX.....X...X..XX.X....XX....XX.....X..X
XXX...X..X.............XXX.....XX..XXXXXXXX.X....XX....XX.....XX.....X.X..XX...XXX..XX.X.XX
.....XXX...XX......XX....XXXXX...X.XX.......X.XX.....XX...X...X..XXX...X.....X...X.....X...
...X..XX......XX......X.....X....X.......X....XX..X..X..X...XXX....X.....XXX.......X...XX..
XX.XX.XX..XX.....X...XX...X...X...XX.X...XXX......X.X..XX........X......X.......XXXX.X..X.X
XX....XXX.XX...X...X..X.X.......X.X..X...X...XXXX.....X......X..........X.X...XXX..X.XX....
XXX..XX....X....XXXXX...X.......X.X......X.X...X...XXXX.XX.X...XX.....XXX..XX......X.X...X.
.....X...X....X..XXXXX.....X......XXX....X.XX....XXXX...X..X...X....X.XXXX.......X.....XX..
.XXX...X....X..X..X....X...X...X...XXXX..X.XX.X...X....XX........X..X.......XXXX...XX.....X
.......XX...XX....X...XX...XX..XXX.....XXX.....XX....X....XXX...XX.X......XXXX.....XXXX..XX
X......X..X........XX...XX..X.XXX...XX.....X.X.X...X.XX.......X..X...X.........XX...XXX....
X...X....XX...XXXX.......XX...X...X..........X...X...X...X.......XX.....XX....XX..X.....X..
X.....X...XXX......X...X.....XX......XXXX.........X....X.....X....X.X.X....X..X..XX..XX...X
X..X....X......XXX.X.XXXX....X.....XXXX..XXX....X...X.....XX.XXXX...X..XX....XX....XX......
XXXX.X......XX.......X....X..X.XX....X...X....X.XXXX..X......XXX.....X....X..X...X.......X.
.....X.X.......XX.XX...X..X..X....XX...X....X.X.......XXX..XXXXX.XX..XXX..X....X.X...X...X.
....XX.....X.X.XX.XX...X.......X..XXX.....X...........X.......X..XX.XXXXXX.........X...X...
..X.X...XX.X.X..X........X......XXX...X...XXXX..........XX..X...X...X...X..X..X...XXX..XX..
..X.X.XX.....XX...XXX.......X.X.XX..XXX..XXX.......XXX..X...X.........X...XXX...X..X..XXXXX
..X...X...X.......X...X...X...X....XXXXX...X.X..........X.X.X..X...XXXX.....XXX....X.XXXXXX
..XX....X...X..X....X...XXX..XX.....X........X....X.X.......XX.XXX..XXX.....X...XX.X.......
...X.X..XX..X....X..XX........X...X...X.....XXX...X.X..X.X.XXX...XX.XXX..........X.X..XX...
.X......X.....X.....XX...XXXX.XX..XX...XX....XX.XXX.XX...X...XXX.XX.....X....X.X.X..X....XX
.XX...X.X........XX..XX.....X....X...X.X.....X....X.....XXXX.X............XX.X...XX......XX
..XXX..........X..XX....X.X......X.XX....XXXX..X...XX...X....X....XXXXX......XX......X...XX
X......X.......XX......X..XXXXXX.X....X.......X..X....XXX.......X....XX.....XX....XXX.....X
X..X.......X...XX..X.....XX...XX...X..XXXXXX....XX..XXXXXXX..XX...XX.....X.....XXXX...X.X..
...X....X..X...XX..X..X...X.X.............X..XX.....XXXX.....X....X..X.X...X.XXX......X..X.
.X..X...X.X....XXX..X...X.....X...X.......X...X...X.X....X...X.XX.X....X...X.....X....XX...
..X...X.....XX............XX...XX.......XX....XX..X...X......X.X....X.........X...........X
X......X...X...XX....X.XX....X.X...XXXX....X...X.X....X...XXX..X.X....X...XX......XXXX..X.X
X..XXX.....X.....XX....X...X.....X.......X...X.X...XX...X.XXX.X..XXX..X...XX.X.....X....X.X
X..XX.........X.....XXXX.X......X..X..XX.....X.X....XX....XXX.X.XX..XXXXX........X....X...X
X.....XXXXX...X.X....X........XXX.XX.....XX..X.X.XX....X.X....X.......X.....X.......X...XXX
X......XXXXXX......X......XXX...X.XX...X.X...X......X....X.....X........X.....XXX....XX....
XXXX.........X...X.XX...X.....X.X..X.......X.XX...X...X....XXX...X...XX....XXXXXXXXX.XXX...
......XXXXX....X.X....X.....XXX..X......XX......X........X.XX..XX..XX....X........XX..X....
.XXXX...X...X....XXXX....X..XX...X..XXX.............XX.X.X.....XX.....XX..XX..........X.X..
....XXX...XX..XXX......XX..XXX.XXX....X...X....X....XX...XXX...X..XX....X....XXX...X....XXX
X.....X..XXX.XXX.....X....XX...X...XX.....X....X...XXXX..XX..X....X..XX...X......X...X....X
X..X..X......X...X.X...X..X..X...XXXXX....XXX....X.XX...XXX...X.....X.......X..........X..X
...X.XX...XXXX.XX..X......X.........X..X....X.XXXX.XX.X...X.X....XX....X...XX.X...XX.....XX
.X.X....XXXX......XX....X..XX...XXX.X....XX.X..XXX..X..X..X....X.....X...X..X..XX.XX.X..XXX
.X...........XX.XXXX....XX....X..XX...XXXXX....XXXX....X.X...X....XX....XX..XX..X....X.....
...XX.........X...XX..XX....X..X.XX..X.......X...X.........X....X.......X...XXX........X...
X..X..X.....X...X.X....X....XX.X...........X.X.X.X.XXXX...XXX.............X..X...XXXX.....X
..X..XX.XXX.......X.XX......X..XXX....XXX..X...X.X....X....XX..X.......X...X...X...X..X.X.X
.XX...X..XXX..........XXX.....XXX..XXXXX..X......XXX..XXXX.....X.......X.X.....XXX...X..X.X
....X..X....XXXXXXXX...XXXXX...XX........XX.....XX...XX....X...XXX.....X....XX..X....X.....
..X....XXXX.....XXX..X.....X.X..X..........XXXX.X....X..XX.....XXX.XXX..XXX...X...X..XXX.X.
.....XXX..........X.....XX...XX...XXXX..X.......X.X..X...X..XX.....XXXX.X...X..X....XXX..X.
.X.X.....XXX...X......XX......XXXX......X.X............X.X..XX....XXXXX...X.XX...X....X....
.X......XXX..X...XX....X.XXXX...XX..XXX..........X.XX....X..XXX......X..XX..XXX....XX.XXX..
......X...X.....X...XX...XXX....XXX........XX......XX.X.X....X.....X.X.....X......XX....X..
...........XX.....XXX.....XX.XX...XXX....XXXX...X.......X.XX...X...X...XXXXX.XXX.....X.....
.XXXXX...X........X...XXX..X....X.....XX..XX.....XXX.XX...X...X....X.......X...X.XX......X.
....X..X............X....X...X..X..XXXXXX....X.X...X..X..X..X.X....X.......XXX......X..XXX.
..X...X..........X....XX.X......X.........X....XXX....XX.X.XX.XXXX............X...X....X...
..X..XX.X.XX.........X...X....X...X....X....X....X.....X.X.........XXXXXXXXXX.XXX...XX...XX
..X..X..X..X....X.X....XXX..XXXXX...XX...X.......X...X.......X.......XXXX..XX....X..XXX...X
..X....X...X......X.X........X......X....X...X....XX....X......XX.......X...XXXX...X....X..
..X.X..X.XXX...X.....XX..XXX.X...X..X....X.....XX.....X.X.....XXX...X.....X....XXX.X.....X.
....X..X..XX....XX.X.XX....X.......XX...X...X..XX...X.....XXX.X...X.X.XX.....X..XX.....X...
..........XX..X....X....XX......XX....X...X.......X....XXXXXX...X...X......XXXX........XX..
