18 18
..XXX......X......
..X...XXX..X......
....X.....XX..X...
........XXX...X.X.
XX.X.....X..X.X...
XX.....X.X.....X..
....XXXX.....X....
..X..X............
X..X.......XX..XX.
XX.XX........XXXX.
XX.X..X...XX....X.
...X....X..XXX....
.XXX...........X.X
...XXXXXXX...XXX..
XX....XXX..X..X...
....X...X...X...XX
.XX.X....XX.X.....
....X..X....X.....
