14 16
X......XXX......
....X......XX...
.X....X....XX...
.X.XX...XX.X....
.X....XXXX...X..
...X........XXXX
.....XXX........
..X...XX.XXX.XX.
....X........X..
.X......XX.....X
...........XX...
..X...XXX..XX...
..........X...X.
.....XXXX...X...
