16 17
......XXX........
..........X...XX.
..XX.X...X..X.X..
..XX...X.X.X..X.X
.....XXX...X....X
...X...XX........
.X......X....XXX.
.X......X..X.....
.XX.....XX......X
.X..X...XX..X....
.X.XX...XXXXX..X.
...X....X......X.
X....X....XXXX...
..X....X......X..
.......X.X.......
.......X...X.....
