107 107
........XXXXX...X..X..........XXX..X......X..........X....XXXXXXX..........XXX....XXXXX......X....X........
.XXXX...X..XX.X.X....X..XXX.....X....X..X...XXX........X..........X........XXX.XX.X.....XXXX....X..........
.X..X..XX...X.....X.....X.........XX....X.......XXX.X....X........X..X............X...........X....X.......
....XX....X....X..X...X.X.XX.....X...XX...XXXX...XX.....XX......X..X.X..XX..XXX....X...XX..XX....X.....X...
X...XXXX...X..X...XX..X...X........XXX...XXX...X..XX....XX.XXXX.XX...XX.XX.....XXX...X.....XX..X....X..X...
..X..XXX......X.X.X..XXXXXX...XXX......X.....XXXX....X...X..XXX...X......X.XX.......X....X...X.XX...X.X....
..XX.XXXX...X...X...XXXXX..XXXXX..X....XX...X......X.X.X..X...XX....X..X.X....X.....X.XX...X...XXXX.....XXX
...X....X...XX..XX......X..XXXXX.XX....X..X...XX...X...XX...X..X.X....XX..XX..X...XX..XXX..XX..XXX.....XX..
.X...XX.....XX..XXXX.X..X......X...XX..X.X....X.......X........X...X...XX..X....X.XX......X...XXXX.........
.XXX.XXXXX...XXXXXX..X.X..X........X...X.X....X.X.X..........XXXXX...X.XXX...XX....XXX...X..X......XXXXX...
.......X...X...XXX..XX.X.XX.X...X....X.......XX.....XX.....XXXXXX...XX......X....X..X..X...XXX.........XXX.
....X....XXX.....X...X...XX...X.....X...X....X......XX...X........X...XXX.XXX....XX...XX....XX...XX.XX.....
.X..X...X.....XX...X..X...X......XX...X.X...XX.XX........X.....X..XXX.....X......XX..XXX....XXX.....XX..XXX
.X.X..XXX..XX.X.......X.X.X..X...XX.......X..X.....XX.....XX...X..X.........XX...XX..XXXX.......X.........X
.....XXXXX....X.X.......X.X......XX..X...XXX.....X......X...................X..X.XX.....X..............XX.X
X.....XXX..........XXX....X...X..XXX...X..XX..XX.....XX...XXX...XX.XX.......X....XX.....X..X...XXX........X
..XXX.X...XXXX...X.XX....XXX.....X........XX..XXX..XXXXX..X...X....XX....X..X.....XX...XXX...X.....XX......
..XXX.X..XXXX..X......XXXXXX.X...X......X...X......X.....XX.X.XXX......X.....XXXX..X.X...........XXXX....X.
......XX...XX.....XXXXX........X....X.......X....X...XX...X..........X....XX.XX....X.X....X......X..X.XX...
.XXX...X....X...X..XX......XX.....X...XX.......X.XXXXXX.X....X...XX..X..X.X.....XX...X.XX.XXX...XX....X...X
..XX.X.X..X...X..X.....X.X....XX..XX..X....XXX.....X....XX.......X...XX.X...X.......XX.XX...X.X....XXX..X..
X....X.X..X..XXX.....X...X..X....X..XXX.X..XX...X....X...X.XXXX..X.X..X.XX........X.X..XXX....XX.......X...
...XXX.XXXXX......XX............XX...X..X.XXX.XXX.X....X.X.XXX.....XX...X....XX.....X.X....X......XXX..X.XX
.X.X...X...X.XXXX..X..X......X..X..X...XX.X...X........X.X.X.........X..X....XX.XX....X.X.......X.XXX..X..X
.X...X...X.X...X...XX.X......X.XX...X...X.X.X...XX.....X...X..X.......XX...X....X..XX.....X....XX.....XXX..
....X....X..X....XX...X....X.X.X..X...X.....X...XXX...X.......X.X...X....X......X.....XX....XX..XX....XX...
X.....X..XX...X.........X....X.X......XX...X......X.X.X.....X.....X....X....XXX...XX.......XXXX....X..XX.XX
..XX..X..X..XX...X...X....X.XX.X......X..X...X......X.XXXX...........X......XXX..............XXXX...XXXX.XX
...X..X..X...X.X.XXX.....X..X..X.....XX.XX....XX...XX.X....X.......X....X.X..XX..XXXX....XX.....X.X....X...
.X....X....X.X......X.X....XX.X..XXX....X...X....XXXX...X.....XX......X.X....X.....XX..X....XX....XX...XXX.
.XXXX...X.......XXX...X.X.......XXX.......X.X.....XXXX......X.......X........X.XXX.XXXXX..X....X.....XXXXX.
............X..XXXX......XXX...XXX..XXXX....X...X..XXX.X....XX......XX...X.....X...X......X.X..X...XXX..X..
XX...X...XXX...X....XX.X...X.......X..XXXX.XXX.....X...XXX..XX.....XXXXX...XX..X..............XX.X........X
...X.X.......X.....XX..X......XXX..X...XXX...X.X........XXXXXX............XXX..XXXX.X......XX....XXX...X...
.X...X..XXX.....X...X.......X........X.......X....XXX.X....XXX....X.XX......XXXX....X.X.XXXXXXXXXX...X...X.
.X...X....X.X.....X.........X..XX...XX..XXX.......X...X..X......X...XX.XXX.....X.XX...X...X............XX..
.....X......X.XX.X...X..........X.X...XXX...X....XX......XX...XXX............X...XX.XXXXX...X.....X.X.....X
..X..X...X....X..X.X...XX.....X...XXX...X..XX..........X.....XXXX.....X....X....XX....XX......XX....X.X....
....XX......XXX.......XX..XXX.XX..XXXXX..X.XX.....X......X.X.XXXXX....X.XX.X..XX...X.....XX..XXX.X.........
.XX.XX....X.XX....XX.....X..........XX...X.XX...XXX....XXX...X.....XX...XX....X....X...X..X..X.....X.XX....
.......XX......XX....X.X...X.X.........XX..XX....XXXXX....X..X..XXXXX..X....X.X.X....X....XX.........X.....
...X.......X........XX...XXX......XX....X.X......XXXXXX......XX.X...X....X..X.X...X.....X.....X...XX...X...
.X....XXXX.....X..........X...X......XX.....XX.....XX....X...XX...X...X....XX.X.......X...X.X...X..........
.XXX....X...XX.X.....XX...X........X.X...X.......X.....X.X....XXXXXX....X...X.X....XXXXX....X...XXX.....XXX
.....X....X......X....X..XX...XX...X...X......XX...XXX...X.XX........X....X.X....X.....X.X.........XX...XXX
....X..XXX..XXX....XX..X.X..X....X........XX....XX.XX...XX.............X.......X.....X.........XX....XX...X
....X......X....XX.....X.X.....X......X.XXX..XX.......X.XXXXXX...........X...X.XX.......X......X..X.......X
.....XXXX..X........XX.......X........X...X.XX....X..............XX........X...X..X.XX.........X.XX...X....
...X...XX..X......X.....X...........XX..X...XX......XX.X...XX.......X...XX.X..XX....X..X............X...XX.
........X..X...X..XXX...X..XX.....X..X...X..XX.....XXX.X.X..X...X.....X....X...X.X....XXXXXXXXX...X......X.
XXX...X.X....XXX.XX.....XX..X.....XX...X.......XX....X...XX...X...XX......X..X.X.....XXX....X...XX.....X...
..X.XXX...X.........XX..XXX.XXX....X......XXXXXX..X..XX....X..X..XX...XX....XX....X....X.X....XX...X...XX..
....XXX...........XXX...X.....XXXX.X....XX.......XX....XX.....XX....X....X..XXX...X.X....X.X.......XXX.....
.XXX..X....XX.....X...X..........X..X.........X.....XX.XX.....XXXXX..X......X...X.....XXXX......X......X...
..X...X.......X.XXX......X.....X.XX.....X...X...X....X....X..........X..XXX.....XXXX.X..XX..XXX...X........
X...X.X.......X........X...X...X.....X....XXXXX......XX...X..X.....X..X...XX....XXX..X..X....XX.....X...XXX
...XX....X........XX.X.......XXX..XX...X.........X......XXXX...XX.....XX..XXXX..XX..X...X..X....XX......XXX
.X.....XX..X.........X.XX.....XX.........X.....X.....X..XXXXXXXXX.X......X.......X....X.XX.XXX..X..X....XXX
.X..XX....XX....XX..........X.....X...X....XXX....X..X.....X.....................XXX..X....X....X.X.....XXX
.X..X..X.....X......X.........X.X...X...X...XXX.....X..X.........X.XXXXXX....XXXXXXXXX.....X....X...X...XXX
......XXXX.X...XXX..XXX..X......XXX.XX..XXX...X..X..X.....X...X....XXXXX...X.......XX..XXX.XXXXX....XXX.X..
XXXX..XXX..XXXXXXX.XXXX..XXX.XX...X...XXXX....XX.XXX...XX...XXX.X.....XX.X..XX........X....XXXXX........X..
..XXXX..X....X.....XXXX....X....X.X.....XX.XXX.......X.....X........X....XX.....XXX.....X..XXXXX...X.......
....XX.....X......XXXXX.X....X..X........X.X....X...XX..XX.....X....XXX..X....X.....XXXX...XXXXX.X..XXXXXX.
.XX..X...X....X.....XXX.X.X........X...X...X..X.....XXX...X.X..X...X..X..X.XX....X..XX...X....X..XX.....X..
.XXX...X..X.............X.X...XXXX...XX.....X....X..X...X...X.X..X.X....X..XX..XXX.X...XXXX.....XXX..XX...X
...X......X.XX.......XXXX...XX......X...XXX.X.......X...X..XX...X....XX...X....X...X.X.......X.X..X..XX....
XX....X...X...XX...X..XXX........XX.X..XXXX.....XXX.....X....XXXX.X....XX...XX.......X.X...X.X.X..XXXX..XX.
X...X..XX..XX....X....X...XXX....XX.XX.....XXX......XX....XX.........X......X.....XXXX....XX...X.......XX..
..XXXX.....XX..X..XXX.....XXX.......XXXXX..XX..XXXX....X...X.....XX......X....XXX..X....X.XXXXX..X......X.X
...X..X........XX....X....XXX...XXXXX.....X...X..XXX.....X.X....X...X.XX..XX.......X........XXX.......X...X
XX....X........XX..X..XX......X..XX.....XXX..........XX....X..X...XXX...X......X......XX..........X........
XXXXX..X.....X..X..XX....X.......X...XX.XXXXXX......XX..XXXXXXXX..XX..X.X...........X.XX...X..X......X.....
X......X.XXX....X..XX......X.X.....X.XX........X....XX............XX....X....XX....XX....X....X....X...XXXX
X...........X...X..XX....XXX...XX..X...X.....X.X.....XXX.....XXXX....X..X..X...XXX.XXX.....XX.XXXX.XX..XXXX
......X...X.X...X...XXX..X..X..X.......X.XXX...X...X..X..X...XX....XX...XXXXX....X.X...XXXX...X....X..XXXXX
.XX...X...X...X...X...X.XX.....X....X.....X....X...XX...X....X...X....X..XX...X....X........X.....XX.....XX
.....XXXX..X........X......X...X..X...X.X.X......X...X....X..X.X.....XXX.X......X.....X....XX..X.....XX..XX
XX.X...X...X.X.XXXX.XX.X.....XXX....XXX.......X....X.X.X.....X....XX.XX..X.X.XX.....X...XX...X...X......XXX
XX.X.....X...X...XX.XX...XX......XX......X......X..X...XXX......XX...X..X..X..............XX....X..XXX..XXX
...X..XXXX.XX....XX.X...XX..X....XX..X.....X..........X.....X...X....X....X........X...X..X...X...XX..XXXXX
.XXX...X...X..XX......X.XX.....X.....X.XX....X...XX...X.....XXX...X..XX..XX......XXX.X...X..X......X.......
..XX.X.......X.....X......XX.X.....X...X..X....X......X..X..XX......XXX....X...X........XX....XX.X...XX....
X....XX...X.....XX.....XX....X..X......X....X......X..X...XXX..XXXX.XXX.X....X.X....X...XXX..XXX..XX....X..
...XX...X.....X..XX........XXXX...X....XXX..XXXXX....X..X...X.XXXX....X.X.X.XX...X..X..XXXX.....X..X...XX..
...X..X....X.....XX..X...X..XX....X..XXXXXXXXXX...XX...XXXX...X....X....X.X.XX..XX..XX....X.XX..XX..X..XX..
..XX.XXXX....X....XX...X..X....X..X...XXXX..X...X..........XX....XX..XXXX.X.XXX..X..XXX.....X..X....X.XX...
.....X......X.....XX..XXX.....X.....X....X....X...X..XXXXX.....X.XX.....X...X....X..XX...XX...XX......X..X.
...X...X.X..X......X...XX..XX.X....XXXX....XXXX.XXX....XX....X.....XXXX..X....XX....XX.X......XXXX...XX....
.X....XX...X...XXX...X.XX..XX..XXX.X....X....XX.....X.....XX....XX...XXX.X.X.....XX........X..XXX..X.......
....X.XXX..X.X.XXXXXXX..X....X...X.....X.....XXXXXX.X...X...XXXX.......X.X.XXX.X.XX..XX.XX.XXX....X...XXXX.
XXX...XX...X.....XX.....X....X......X....XXXXX...XX...X...X..X...........X.....X..X.....XX...X......X...XX.
XX.....X.X....X.....XXXX........XXX...X.....XX.X.....X....XX..........XXXXXXX...X...X.....XX.X...XXXXXX..X.
XX.XXX...XX.....X.XXX.......X....XX..XXXXXX....XXX.X...X..XXXXX.....X.........X..X........XX.X.X.......X...
X..X......X....XX.........X...XX..XX...XX..XX..X...X.....XXXX...X...X...XX...XXX...X.X....XX...X..XXX......
X.........XX.........X....XX....X...XX..X......X......XX......X...XXX...XX.X......XX......XXX..X..XX..X....
......XXXXXX..X.XXXXX...X....X......XXX.X.XX...XXXXXX..XXX...XXXXXX......X.X......XXXXX...XX...XX....XX...X
.XXXX...XXXXX...X.....X...X....XX....XX...XX.XXXXXXXXX.....X....X......X...X.....XXX....X..X.X....X.....X..
.XX...X..X...........X......X.....XX..XXX....XX....XX...XXX.....X....XXXX.....X....X.XX.XX.....XXXX.X..XXX.
.....XXX.......X.X.....XX........X....X...X..XX.X..XX...XX..X........XXX..X.X...X...........X..XX...X..X...
XX.X..XXX.X..X.X....X...X..XXX.....XXX....X.....X.XXX..XXX.......X...X...XX.......X....X......XXX.XX...X.XX
XX.XX...X....X..X.X...X..XXX...XX......X....X.X.....X.....XX.X.....X.....X...X.X.....X..........X....X.....
X..XXX....XX.XX...XX..XX.......XXXXXX.......X.........XXX..X.X..X...X......X.X...X...X..XXXXXXX.........X..
X...X..X...X.X.......XX..XX....XXXXX..X..............XXXXX...XX...X.XXX...XX.XX....X..X....XXX...XXXXX..X.X
..X...X..X.X.........XX........XXXXX.......XXX.....XXXX..XX...XX....X...X.......XX.XX....X.X...X.XXXXX..X..
......X.XX....X......XX...X....XXXXX...X.....X.X....XX...XX.X.XX.X..X.....X...X........X.X.....X..XX....XX.
......X.........XXX..XX.....X..XXXXX.....XXX...XXXX....X....X....X..XXXX..XXX...XXX......XXXX..XX....XX....
