105 106
......X......X..XXXX.......XX..XXXXXXX...X...XXX.....X...X....X............X..XX......XXX..X...X.....XX...
......X......X..XX.........XX..XXX.....X...X..X..XXX.....X....X.XXXX.....X....XX..XXX.XX...X.X...XXX....X.
..XX..X..X...X..X.....X....X...X...XX..XX..XX...X.....X..XX...X......X........XXX...X....X...XX......X..X.
X.....XX...X....X.X.X...XX.X.X.X.XXXX..X...X...X..XXXX...XX.X.XX........X.......X.....X..XX..XX.X......XX.
X..XX.XX.....XX.X.X......X.....X....XXX..X...X...X...X.X....X.....XXX.X.....XXX.............X...X..XX.....
XX..X.....XX.XX...XX...X...XX...X...X...XXX...X....X............X.XXX..XXX..XX.......XXXXXX.X....X....XX..
XXX....XX..X...X....XX..XX....X.......X...X.X.....XXX...XX...........X.....XXX.....XX.......XXXX..XX......
...........XXX...X......XXXX.....X...XX.X......X..XX..X........X.XX..XXXXXXXXXXXXX.....XX..XX.....XX...XX.
.X....X............XXXX......X.X...XXXX....X.X...XXX....X...X..X....XXXX.............X.XX.....XX....X..X..
...X....XXXXXXX.....XXX....XX..X..XX..XX...X..............X...X..X.....X.X........XXX.....XXXXX..XX...X..X
.....XX........XXXX.XXXX...X..XX..X...X..XX.....X........XX..........X...X..X...X.XXX.X....X....XXXX..X...
..X..XXX.......XXX..X......X...X....X...XX..X......X...XX....X....X..X..XXX...X.X..........X.X..XXX...XXX.
X....X.....XXXXXXX......X....X.X.X..XX..XX.....X.X.X...X..XX....XXXXXXXX........XXX..X............X...XXX.
..XX.........X.....X......X..X......XXXX.....X.X...X...X.X....X.XXX......X.....XXXX.....X...X.X.......X...
.X..XXX...X....XXX.XXX....X.......X...XX..........XX.X.....X..X.........XX...X.XX...XXX.X.....X.........XX
.X......X...X...XX...X......X.....X....XXXXXX...X.XX....X....X.....X....X..X....X.......X..X.........X.XXX
...XX..X....XXX...XX.X...X....X...X..X.....XX...X.X...X...X..X.......XXXX..XX.X.....X..XX...XX.....X.X...X
....X..X.X....XXX.XX...X...X......X.....XX..X.X.....X.....X......XX.....X...X.X..XX.X.....X....X......XX.X
....X..X.XXX......XXX........X............X.X....X.....XX.....X..X..X.....X...X...X...XXXX...X..XXX.X....X
X......X...X.......XX.XXX......XXX.X...XX.X....X...X....X..XXXX.XX................XXX......X..X.....X..X..
X....X.XXX.X...XXX........X.X......X....X....XX.....XXX.X....XX....X...........X..............XX...XX.....
XX...X.......X.......X......X.X.XXX...X....XX...X.X..XX.X..X..X..X.....X...........X.XX...X....X.X........
XX..XXXXX...XX..X....X...X.XX...X...X....X......X.XX..X.XX....XX.......X..XXXXX.X....XX.X...XX.X...X......
XXX.......X...X...XX.XXX.X.....XX...XX.X...X....X..XX.X.X...XXXX.....X..X.......X.X..........X..........X.
........X...X.X....X.........XXX....XX.....XXX..XX......X.X..X....XX.XX.XXXXX...X..XXXXX.XXX......XX....X.
...X..X.....X....X........X......X..X......XXX..XXXX......XX...XX..X.XX.....X.X..X...XX..X....XXX....X..X.
...X...XXX....XX....X.....X.XXX..X..X......XXX..XXX.......XXX..X...X.....XX......X......X.........X...XXX.
.....X.....X......X...X...X..X...X....XXX..XX..XXXX.XXXXX..X.....XXX..XX.....X.X..........X.........X..X..
..XX....X....XX......XXXX..X.X...XXX......XXX.....X..XX..X...X....XXXXXXXX.....X.XX.........X........X...X
XX....XXX.X.....XX.X.XX..X.....XXXX..X........X......X...X..XX.XX..........XX.......XXXX........XXXX....XX
......X......X...X...XX.....X..X..X......X......XX.....X..X....X...X.....XXXX...X....XXX..XX.XX...XXX...XX
..X...X.XX.X...X.XX...........XX......XX.XXXXX.....XX..XX...X....X.X.XX..X....X.XXXX..XXX....XX....XX...XX
X...X...X..X.....X..X......X..XX...XXXXX...XX..X...XXXX...XX....XX...X..XX......XXXXX......XXX...X....X..X
X......X..XX.....X.XX.X.XX....X..XXXXXXXX..X..XX..XXX...X....X....X....XXX.....XXX..XX...X.....X....XX...X
...XXX.X....X....X....X.XX..X.X...XX......X..X..X...X......X...XX.....X....XXX...X...X.X....X..XX.XX...X.X
.X........X...X....X..X.........X....XXX....X...XXX......X.........XX.X.....XXXX...X.X.X....X.....XX...X..
.X...XX.X.XXXX..X....X...XXX.XX........X...XX.X..X.........XX.X.....X.....X.X..X.......X...XXXX...........
...X.XX...........XX.X.X...X.X...XX......X.......X......X..X..X.XXX..X....X....X....X.......XXXXXXXXX...XX
X........XX......XXX...X.....X.X.XX.X......XXX....X.....X..X.......X.X.XXXXXXX.X..X..XX...X....XXXXX..X...
X.X.XXX.....XX....X.......XXXX...X....XXX..XX...X.X..X..XXX....XX....X.....XX..X...X....X....X.XXXXX...XX.
X.X.....XX..X..XX...XXX....X.......X.....XXXX.X...XX.XXXXX..XXX...X.XXXXX..XX......XX.....XX.........X.X..
.......XXXXXX..XXX.....XXX.X..XXX..X...X......X....X.......XX.....X.......XX....XXX....XXXX...X.....XX...X
.X.XXX.............X.......XX....XX..XXX..XX..X.XX.XXX.....XX..X..XXXXXX..XX.X.......X......X...XXX..XX...
.X...X........XXXX....XX....X..X....X..XXX....X....XXX.XXX...X...............X...X...XX...X...XX.....XX...
..XX.X.....XX...XX.XX..X.XX..XXXX..X...X....X..X...X.......X....XXX....XX..XX......X....X.....X..X....XX..
X....X.......XX....XXX...X...X.....X.X....X..X...X....X.......X.....XX...X....X......X...X....X....XX.....
X..X......X..XX..XXXX...XX.......X.....XX..X.XX.....X...X.XXX.XXXX.......X...XX...X....X...X..XXX......XX.
........X...XXX...............X..XXXX...XX......X.......X..XX.XX.....XXX..X..X..XX..X...XX..XXXX..X.......
.XX...XXX.....X...X....X.XX.....X..X..X.......XXX..X.XX....X..XX.....X....X.X..X...X....XXX.......X...X.XX
.X....X.........X...X..X....XX..X....XX..X....XXXX.X.....X...XX....X...XX.....XX..X..XXX..X..X......X.X..X
...X....XX.....XX..XX.....XX...X..XXXXXX...XX.XX.......XX.......X..XX..X...X...XX.X.......XX...X.........X
..XX............XX....XX.....X.X....X......XX....XX.XX....X...X...XX.....X...X....XXX...X............XXXXX
..XXX..XX.......X...X....X........X...X..........XX....XXXX...X......X................X...X.....XXXXXXX...
..XX.......XXXX...X...X.......XXX.....XXX...XXXX.XX...XXX...XXX....X...XX...X....X...XX.........X.........
.....X...X........XX..X...XXXX.....XX.XX..X...XX..X.X...X.X...........XXXXX.X..X.X.X.....X......X......X..
.......X....XX....XXXX..XXX......X..X..X....X.XXX...X.....X...XX..X.X.....X.XX.X.......X...XX...XXXX...X..
XXXX....XXX....X..XXX..XX...X.....X..X...X..X....X.....X...XX...XXX..X....X......XX.X..XX.......X....X....
XXX..XX..XX..X...XXXX.....XXXXX.X....X..X..X..XX.....X...X..X........X.X..X...X..XX...XXX...XXX...X..XX...
....X..X.XXX.........XXX........X.....X...XX......X.........X..XX......XXXX.X.X....X....X...XXX.XXX..X....
.XXXX....X......XX...X...XX...X...XXX...XX...XXXX...X.....XXX.....XXX.......X.X......XX...X.....XX...X....
......X....XX.X....XXX....X.X.....X..X..XX.....X........X.....XX..XX..X.......X...XX..XXX..........X......
XX...XX...XX..X.X.......X...XX....X.....X....X...X...XX..XXX..XX..XX......XX..X...............XXXX....X...
X..X..XXX..X......X..XX......X....X.......XX...XX....XXX......XX..X....XX.X..X....X......X..X....X.XX.....
..X...X..X....XX.....X...XXX...X.........XXXX..XX.XXXX........X...X.X...X....X........X..X...XXX...X...X..
.XX......X..X....XXX...X..XX...XXX.XX.....X...XXX.X..X..XXXXXXX...X...X..X...X...X.X....X..X.....XX..X....
....XXXX..XXXX...XX.......XX...XX..X..XXX.X.....X....XX.....XX.....X..XX.......X...X.X....XX........XX.XX.
..X.....X..XX..XXXX.....X..X....X....XXXX....XX...XX..X..X.....XX.....X.....X..XX....X..........X....X....
..XX..X....X..XX.....XX....X..X..XX......XXX..........XX...X......X.X...X......XX.X..X....X...X......XXX..
XXXX..X......XXX.XXX.....X..X..X....XXX..........X.........X...X..X.X........X.XX...X..X....XXXX...XXXX...
......X.......X..XX......XX....XX.....X.X......X...XX...X....X...XX......XX....X......X..X....XX.X.XX...X.
....X.XXX...X.X.....X...XX.....XX...X...X....X.....XX.X...X...XX.X...X......X....X......XXXXX.XX.X.X....X.
XX..X.....X.X.X..X....X....X....XX..XX....X.....X...X.........XX.X.....XXX..XXX.....XX....X...X....X.X....
...XX...XXX...X..XXX..........X....X...XXX..X.X...X.XX...XXXX....X...XXXXX..XXX...X.X..XX...X...X......X.X
.XXXX.X......XX....XXXXX..X.X.XXX....X.....X..XXXXX....XX...X..XX..X.....XXXXXXXX.....X....X....XXX.X....X
......XX........XX...XXX..X...X.....XX....X..XXXXXX..X..X.X.XX..X.XX..XX.......X...X.......X.X....X.X.X...
XX...X.....XX.XXXXXX...X...X..X.XXXXXXX.....X..XXX......X....XX...X.....X........XXX.X.......X.X....X...X.
X..X....X..XX..........X.X...XX....X..X..X.....X.....XX.XX.X..X..X..X...X.....X.XX..........XX.X.X........
..X...X...X...X...X......XXX.....X.X..XX.....X.X.....XX..X..X...X..X..XXXX..X.X.X..XX.XXXXX....X.......X..
.XX.X....XX.X...X..XX.XX...XX....X....XXXXXX.X.........X.XX..X....XX.X......X.X...XXX.X....X......XXXX....
....XXXX.X..XX...X..X.X..X......X..XX.X.............X..X.X...X.X.....X....X.......X...X.XX...XXXX..X......
..X....X.X...X.X..X...X.XX..XX..X...X....XXXX.....X...XX.X.....XXXX.....X....X....X.....XXX........X..X...
X....X.X.XXX....X.X..XX..X......X.X....X...X..XXX.....X..XX..X....X...X...XX.XXXXX..........X...XXXXX.X...
...X.X........X.X..X...X...X......XXX.........XXXX....X...X..XXXX...XXXXX....XX....XXXXX....X.X..XX.......
.X.X...XX..........X.X.XXXX..X........X........X...X...XX....XX..XXXXX.....XXXX.XX..XXX..XX.X..X....XX.XXX
.X.....XX.....XX.......X....XX.......XX..XXXXX...X.X.X..XX...X...X...X...X....X.....X...XXX..X.........XXX
....X.....XX..X.......XX...X...X........XX...XX..X.X..X..XXX...X...X.XX..XXX..XXXXX........X....XXX.....XX
X...X...X....XX.......XXXX...X......X.X....X.XX....XX.XX.XXXX..XX..X....X....XXXX......XXX....X......XX.XX
..XXX...X.X........XX.X.....X.....X.X.X..XXX....X...X......XX..XX..XXX..X.XXXX....XXX.......X......X.XX..X
.XXXX.......X.XXX.....X.X.XXX.X.X.....X...XXXXX.....X...X..X.......XXXXXX......X..X.......X....XX........X
..X......XX...X...X.......XX....X.......X........X....X....X.............XX...X...X..XX...XX.XXXX.X...XX..
X...XXX....X.....XXXXX...X...X......XXXXXXXX...X...X..XXXX.XXXX...X..XXX....X.X.X....X..XX...XX....XX.XX..
X.....X.XX...X.X...XXX...X.XX....X..XXX..XX..X........XXX..X....X..X.....X..X........X.XX..XXX...X.XX.....
....X...XXX....X.....XXX...X..XX...XXXX.....XXX...X.....X......XXX..XX......XX...XX....XX......X.X....X...
.X.....XXXXXX.....XX...XX....XXX.....X..X...X...X...........XX....X....XX...XXXX..X...X........X....X.X...
...X.........XX.....XX.XXXX............XX.X.....X..X.....XXX....X......X.....XXXX..XX.X...........X.......
..XX..X.X....XXXXXX.......XXX...X...........XX..X..XXX.XXX......X......X.XXX....XX.X..XXXXXXXXX.....XX.XXX
....X.X.....X...XXXXX.XX..X...X.X.....XX.X..X...X....X..XX.XX...X.....XX..XX..X.XX...X.....XX....X..XX..XX
.XX......X..X.....X...XX.X..X.....XXX....X.XX.....XX.XX.........XX....X...XX..X.....XX.XX..XX.X..X..X...XX
.....X...X.XX..X....XX.....X.....XXXX..........X...X.....XX.XXXXX..X..X....X..X..XX....XX.XX..X.XX..X....X
..X....X...XX....XXX...XX....X....X....XX.X........XXXX.....X.....X..X.....XX....XXXXXX......XX..X..XXXX.X
X.....XXX..X..XXX..........XXXXXX....X..X.....X.XX......X......X..X....XXXX...XX...XX.........XX......X..X
........X....XXXX..XX...X..X...X..XX..X....X..X....X...X.....X...XX......X....X..X....XX...XX..XX.....X...
.X...XX...X...X..X...XX.X.XX.X.X...XX....XXX.XXXX....X.X......XX....XXXX...X..X....X..XX.X...X.X.....XXXX.
.XXX..X....XX....X....X......X...X.X...X..XX..XX..XXXX.....XX..X..X.....X....XX.XX....XX.X.....X.X.X.XXX..
......X..X.......X..X....XXXXX..XX...X....XXX....XXXXX..XX.....X..X..XX...XX....XX..X....X..XXXX...X.....X
