18 20
XXX....X.......X...X
..X.XX....XXXX...X.X
....XX..X..XX......X
.XX......X....XXXX..
....X....X......XX..
XX....XX......X.....
XXXX........X.......
XXX.....X.X....XXX..
..X.......X..X......
..X....X...X.....XX.
....X....X.X..XX.X..
.XX...X....XXXXX...X
......X.....X.....XX
...X.....XX...XXX..X
.X...X.X.XXX.......X
.XXX.X.X....XX......
...X......X.X....XX.
XX........X...XX....
