12 14
XX..X....X....
X..X..XX......
X....X....X...
..X....X....X.
....X.........
......X.X..X..
...XX.X....X..
...XX....X....
.....X...XX...
XXXX....X.....
......X...X.XX
............XX
