103 104
...X..X.....X....XXXXXX..X..X.....XX...X.....XXXX..XXXXX...X........XX..X.....X.....XXXXXXX..X........XX
.X....X.XXX.X....XXXXX...X..X.....X..X...XXX.XXX...XX......X...XXXX..X..X..XX.....X.XX..X....X....XXX.XX
....X...XXX.XX...X.....X....XX....X.XXX......X...X....X.X..XXX...XXX....XX...X.X....X...X....XXXX...X..X
..X.X..XX...X..X...XX..XX...XX..X.......X.X.........XXX....X.........XX........X.X....X......XXX.......X
X...X...X.....X...XXX..XX...XXX......XX...X.X.....X......X......X....X..X...XXXX..X..XXXXX...X...X.XXX..
X..XX.X....X....X...X.....X.X....XX...XX......X......X...XX...X...X..X....X...XXX.X....XXXXX...XXX..XX..
XX....XXXX...X........X.....X..X.XX.X.XX.X.XX.X....X...XX...X.....X....XX...X.XXX...XX......X.....X.....
....X.......X..X...XX....X...X...X....X..X......X......X..X...XX...XX.........X..XXXXXX.......X.....X...
.XX.....XXX...X....XX.XX.X.X....X..X.XX.X......XX...X....XXX.....X....XX...X.....X.........X..X..X......
.X..XX........X.X.....XX.X.XX...X.XX......XXX...XXX.....XX...X......X....XXX...X...XXX.....X.XX....XXXXX
.X.....X...X....X....XXX....X...X....X...XX...X.X....XX......X..X...X..XXXXXXX.XXXXXXX.....X.XX.......XX
...XX....X...X.XXXX..XX...X.XXX.XX...XXX.....XX.X.XX....XXX..X...XX.....X.......XX....XX...X.....XXXX...
XXXX..X........X....XX..XX..XXX.XX.XXXX....X..X...XXXX..XXXXXX.X........X.XXX.X....XX....X....XX.XX.....
...X.XX...XXX....X..XX.....XXXX....XXX..XXXXX.......XX.........XXXXX....X.XXX....XXXXX...XX.X.......XXXX
.X......X........X..X...X..XXX.....XXX...X.....X....X..XXXXX.........XX...XX...X..........X.....X....X..
....X...XXXX.X...X....X....XXX.....XX..X...XXX.....X..X.............X.....X..X...X....X.X....X....XX....
..X.X..XXXXX.......X.....X...X....XXX..XX..XX...XX...XX..XX...XX....X.XXX.X......X.XX.X....XXX.X....X...
X...X.....X............X..X..X.....XX..X...XX.XX....X..X.XX.XX...X..X..X...........XX.XX...XXX...XX...X.
X.XXX.X...X.........X.....X.XX...X.XX....X....X...X....X....X........X...X......X...X.XX.X..XXX...XXX.X.
....X....X...XX.....X.X...X.XX...X....XXXX..XX..X......XX...X.X...XX.....XXXXXX...X...XX....XXX.X...X...
.X.....X...X....X.....X...X....XXX..XX...XXX...X..XX...XX.X.....X...XX.....X...X..XX..X.....X.......XXXX
.X...X....XXX...XXXX....X..X....XXX....X..XX...X.....X..X.XX.XX...X.....X....X..........XXX...XX.XXXXX..
.X...X..X..X....XXX..X..XX...XX...X...XXX......X...X.XX...XX..X.....X.X.X...XX..X.............XX...X....
...X..X....X.X..XXX....XX...XXXXX.X.....X...X....X.......XX...X..X....X...XXXX....XX...X...X..X..X....X.
X.....XX.....X..XX.....XX...X.....X..XX...X...X.......X..XX......X.X.....XXX......XX.X...X.XXXX.....X...
..XXX....XXXX...XX.X...XX..XX.XXX....XXX...X......X.X...XX.....X.......X......X......XXX...XX...XXX....X
.XXXXXX..XXX..X..X....XXX.....XXX..X.....X.X.X.X....X.XXXX........XXXXXX....X....X.......XXXX.....X....X
...........X...X..X.X...X...X......X....XX.....X.X.......X...XX......XXXX........X....X..XXX...XX......X
..X....XX......XX...XXX...XXX....X..X.......X.....XX...X...X.X.....X.XX....X.XXXXXXX..X..XXX.X....XX...X
XXX.XX..X.X...........X..X..XXX..XX....X......X.X....X....XX...X.....X...X.X...XX....X.....X..X...XXXX..
XXX.....X.XXXXXX......X.....X...XXXX.X.....X..X..X......X..X......X....X.X...X....X..X......X.X..XX.....
XXXX..X...XXXXX..X........X.....X....XX..........X..X.X.XX...XX.X...X..X.......X..XXX.....X...XX..X.XXXX
......X.XXXXXXX..............X..X.....X...X.X.....X.X.......XXX..X....X...X......XX...XXXXXX...XX.X....X
.X..X.............X......X......XXXXX..XX.X.......X.XX...XX...XX...X....X.X...XX..X.XXX......X..X....X..
.X.....X.X....XXX...........X.X..XXX...XX.XX.X....X..XXX...X..XXX..X...XX...X..XX...X........XX.XXXX..X.
.X.XX....X..X..XX.XX......X...XX.....X....XX...XX.XX...XXX...XXXX....X...X.....XX......XX....XX...XXX...
...X..X.XXX..X.......X.X.....X....XXXX..XXX...X...XX.....XX.....X......X...XXX..X...XX..X.X..XXXX....XXX
X....XX..XXX.....XXX.X.X.XXX......XXXXX.XX..X...XXXX..XX.XX...X.........X....XX..X....X.....XX....XX..XX
X.X....X.X....X......X...XXXX...XXX........XXXX..XXXXXX.....X.......XXX.X.X..X...X.X...X.....X.XX.X...XX
X...X....X.XX......XX......XXXX..XX....X.....X...X......X......X..X..XX.X...XX.X.....X.X...X...XX...XX..
XXX.X...XX..XX.X...X..XXXX.......XXXXX.XXXXX...X.....X....XX.X.X...X........XX.............X....XX...X..
....X....XX..X.....X...XXX..X......X...XXXX.......X........X.X...X.....X.X..X...X...X.XX.....XX.XX.X....
...X...X..XX..XXX......XXX.......X.....XX...X...X...X....X.X....XX..XX...X.X..X...X...XX.....XX.X..XX...
XX...X....XXX.....X.....XX...X...XXXX..XX.....X....X...X......XXX....X..XX...XXX.......XXX...XX.X.XX....
..X.....X......XX.......XXX....XXXXX...X...X.....X........XX......XX.....X....XX..X..X........X...XX.XXX
..X...X.....XX..X..X....XXX.X........X...X...X....X...X......XXX.......X.X.XX...X.X.....X...X......X...X
...XX....XX.....XX....X.....X...X....XXXXX......X.....XXXXX..XX....XXX.X......X.X...XX....X....X.....X..
.X....XXXXX..X......X......X..X...XX..........X..X......XX...XX.XXXX...XX...X...X..X...X.....XXX..X.....
....X.X.....XX..XXX..........X....XX......X.X..X...X.X.....X....X....XX...XXXX...X....X..X....XXX.X...XX
X...X...X...XXX..X...X...XX....X.......X..X....X.....X.X......X....XXXX........X....X.X....XX.X.....XX..
X..........XXXXX...X...X...XX....X...X...X..XX....X.......X......X.....XXXXXX..X..X.....X..X..X..X...X..
X..XXXXX.X....X...X...XX...XXXX....X.....X...XX.....X...X......X....X.....XX...X...X......XX.....X.X....
X..XXX...X..X.X...X.X..X......X..XXXX......X..........X....XXX....X...X.X..X.X...X...X.....XXXXX...XX...
X......XXX....X..XX....X..X...X.........XX....XX...........XX.........X..X...XX......X...X.....XX.....X.
X............XX......XXXX.......X....XX.......XX..XX...X....X......X...X....X...X....X......X..X..X...X.
..XXXXX...X.....XXX..........X.....X..X.XXX.....X.X..X......X..XX....X....XX....X.........XX..XX.....XX.
.....X..X...XXXX....X....X...X.X.X.XX....X......X...XXXX....XXXX..X.....X....X..XXX...XXXXXX.XX....X.XX.
.XX....XXX....XX..XXX..X..XX...X.......X.X.......XXX...X.XX..X...X....X...X.....XX..X..X........XXXX.X..
.X..X...XX.XX.XXX.......X....XXXXXX..............X...X...X...X...X.XX....XXXX...XX.....X....X.XXXX...X.X
...XXXX.XX..X.X....XX...XX...X........X...X..........XX....X.....X.XX..X.........XXXXX....X...X....XX..X
..XX..X..XX.X....X....XX....XX.X........X....XXXX....X....XX.XX..X...X....XXXX...X..X...X..XX.....XXX...
...X...X..X....X.....X....X....X.....X.....X.....XX....XX....X...XXX.............X....X.XX..X..X........
.X...X..X.XXX.....X..X.XX..X..XXXXX....X....X.......X...X.X..X...XX...X......XX....XXXX...X..X.X...X....
.XX..XX.X.XXX.X.....XX..XX....X...X.X....XX...X...X...X...........X...X...XX....X...XXXXX....X...X......
.....XX...X...XXXX....X.....X.X.X...XXX.........X.....XX...X..XX..X..X..XXXXX.....X...X..X....XX........
..XX........XXXXXXXX...XXX..X.X.XX....X...X.......XX....XX.......XX..X......X..X....X.X..X.XX....XX.....
.....X..XX.......XX..X.....X..X....X....X.X...XX...X.XX.XXX....XXXX.........XX...XX.X....X....X.....X...
.XXX.XXX...XXXX..XX.....X..X.....X...XX.X..X..XX.X...XX.....X.....X...XXXXX.....X.....XX....X...XX......
.....XXX....XX..X..XX...X..XXX...X..XXX..X...XXX..XX...X......XXX...XXXXXXX...X........XX...X..X...X....
....XXX..XX....XX.....X.......XX.....XXX.....XX...XX.X.X.X...........XX..XXXX..X.....X.XXXX.X........XX.
.XX...X.....X.....XX......X......XXX.X....XX....X....X.X...XXXX..XXX.X...X..XX.....XXX..X...X.X.........
........XX..X........X.X.......X...X......XX..X...X..X........X..XX..X.X....XX..X....XX...X....XX.....XX
...X.X.....XX....XX..X.X.X...XX.......X.XX........X..XX...XXX.X...X....XX...XXX....X..X..X...X...XX....X
.X...X.XX..XX.XX.XX..X.X...X....X...X...XX.....X..X..XXXX..XX...X.......XXX..X...X....X..X.X..XX...XXX.X
....X..XXXXXX.XX..X..X.XX..X...X..XXXXXXXXX....XXXX..XXXXX.........XXX....XX...X.XX...X.......XX.......X
X.....XXX...X..XX....X....X..X.X...XX..X....X..XXX..XXXXX....XXX.....X.X...XXXXX..X.X...XXX.............
XXXX......X..X.XX..X.....XX......X.X...X...X...XXX.....XX.X..X...XXX.....X.XX...X....X..X...XXXXX...XXX.
..X..XXXXXXX.X..X..XX.........X....X.X..XX...X.......X....X.XX.X...X..X.XX....X....X...X..X..XX...X...X.
....X...........X..X....X.X.....X.......X...XXXX.....X.........XXX.X....XX...............XXX....XXXX....
............X....X...X..X...XXXX...XX.XXX.X..X...X.X.....X...X..XX...XXX.....XX.............X....XXX.X.X
...X...XXXX....X....XX...X...XX..X..X...X..X.....X....X....X....XX........X.....X.......XXX...XX..XX...X
.X...X.......X....X....X...X....XXX.....XX..........X...X....XX....XXXXXX...X.X...X...X.XX....X...XXX...
.X..XX....XX.X..XXX..X....XX..X......X...X..XXXXX...XX..XXX..X.....XXXX..X....X..XXXX......XX...XXXXX.X.
..XXXX..X.XX.X....XXX...X..XXX..XX.....X....XXXXX.XXX....X...X.....XXXX......XXX...X...XXXX....XXX....X.
X.X..XX....X....X.X...X........XXX..X....XX.......XXX.XX...X.....XXXXXX.XXXXX...X....XXXX..........XXXX.
X....X...X....X.X......X....X..X...X..X..X..........X...X...XXX..X....X..XX...X...X.X.....XX............
...X...X.X......XX...X...X...XX..X...XX.XX.XX....XX.....X.X...X.X..XX..X.XX...XX....X.XX.....XXXXXXXX...
......XX.....X..XXXX.......X....XX.........X..XX...XX...X.XXX.....XXXX...X.......X....XX...XX..XXX....X.
..X.X.....X...........X.......X..X.....XX....XXXXX....X...X..XXX...XX......X.X.......XX....X...X....XXX.
....X..XXXX.X.XXX.....XXXXX......XXXXX....X....XX.........X...XXXX..X......X......XX.XX......X....X.....
...XX..XXXX...X....X..XXXX.....X..X....X..XXX..XX.....X.....X.......XXX.......X.X......XXXX..XX...XX...X
....XX...........X..XXXXX..X...XX.X.X..X....X...X...X....X.XX..X........X...X...X.X.XX....X..XXXX..X.X..
XXX.XX.........X..X.....X.X....XX...X..X......X.X.X.XX.X...X......X...XX..X..XX...X..X....X..X..XX......
..X.XX..X......XX..X....X.X.X..X....X..X...XXXX...X..X.......XX.X...X......X......XX.X...X...X........XX
....XXX.....X..X...X.X..X....XXX.XX......X..XXXXXXXX....XXX...X..X...X...X.XXX....XX.......X...XXXXXXX..
.XXXXX...X....XX.......X...X.....XX..XX..XX....XXX....X.....X.XX...X.X.X....XX......XXX.......X....XX...
...XX..X...X........XX.X......XXX.......XXXXXX........X.......XXX..X......X....X.......XXXX.....XX....X.
XX....XXX....X...X.....X....X..XX..XXX..XXXXX...X...XX..XXXX..........X......X.....X.......XXX........X.
..XX........XX.X.X...XX..X.....XXX...X..X..X..X.....XX.XXX...X...X..X..XXX.XX........XX.X....X...X....X.
...X...XXX...X.X.X..XX..XX.X....XX......X..X.....X.........XXX.X..XXXX...X.......XX.....X.X......X...X..
.X..XX..XX...X.X.......XXX..XXX.XX..X...X...XX.XXX...XX.....X.....XXX........XX.....X.......XXX...X....X
.XX.....XXX....XX.........X..XX..X.....X..X..X..XX........X...X.......X.........X.......XX......X...X...
............X..XX.........XX.....X...X...XXX....XX..XXXXX............................XX.................
