20 21
XXX.......X...XXX....
....XX..X...X...X..X.
.X..XX...XXXXXX..X...
...XX..X....XX...XX..
...XX.....X....X.....
....XXX...XX..XX..XX.
..X.....X.....XXX.X..
...X........X.......X
...X...X.X.......X...
XXXXXX.X...X.......X.
.......XX......XX....
....XXXXXX...X.X..XXX
..X........X.....X..X
..X..X.....XX.......X
X........X.......XX.X
..XXX.X.....XX......X
.XXX..X.X....X..X....
.X...X..X..X..X...XX.
.X............X....X.
......XX....XXX..X...
