21 22
..XXXXXXXX.....X......
...XXX...X.....X......
XX.....X.XX....XXX....
....X..X.X.....X......
....X..X...X...X.XX...
...X...XX......X....X.
.X...X...XX....XX...X.
..XX.........X..X..XX.
X....XX.XX......XX.X..
.....X..X..XX.XX.....X
.XXX.X....XXX....XX...
..XX...X...X..........
X........X...XXX..XXXX
........XX..XXXX.....X
........X....XXXX....X
XXXXX........XXXX.X..X
..X......X...XX...X..X
....X......X.X....X..X
......XXX..X...X..X..X
......XX.......X..X..X
......XX.......X..X..X
