102 103
.....X...XX...X.......XXXX.....X......XX.....XXXX...X.....XXXX...XXXX...X...XXXXXX....XXX..X...........
.......X....X...XXXX....XX.......X.......XX.....X.X...X.....X..X....X.X...X.XXXXXX.XX...X....XXX.......
..X...XX..XXX..XX..X.X...X....X.............X.X...X.....XX....XX..X...XX...........XX.....XX.....XXXX..
...XX..XXXXXX..XX......X...XX.....X.......XXX..X.......XXX........XX...X...X.............XXX.XX..X.....
.X...X.X..XXX.......X...XXXXX..X.......X.......X.X...X.......XX......X.XX..X.........X.X.....X...X.....
..X....X..XXX..X......X..X..XX...X...X...X.........X....X....X...X..XX.....XX.....XX...X....XX...XXXXXX
X.X.X.....XXXX.....X..XX...........X.X......XXXXX...........XX...X.......X.....XX.........X.X..XXXXXXXX
..X....XX..X.........XX...X...X.X..X........XXXX...XX....XX.XX..XX...X.......X.......XX.....X....XXXXXX
.......X...X...XXXX...X.X.X.X.X...XXXXX....XXX...X.X..X.....XX...X......X.......X....X.....XX..........
...X..X..XXX........X.X.....X.XX......XXX....X.......XX..X..XX.X......X.X.....X...X..X.....XX...XXX....
.X.X....XXX..............XXXX.X..X.X....X.XX......XXXXXX...X...X..XXXXX...X...X.XXX.....X.....X..XX...X
...X...XXX..X..XXXXX...XXXXX..X....X.X....XX..X...XXX..XX..X.XXXXXX...XXXXX.X...XX....X...XX.....XXXX.X
..X..X.....XXXXXX..X.XX......XX.X....X...XXXXXX.X......XX.XX.X......X.......XXXXXX....X......X...X..X.X
....XX....XXXX..X....X......X...X..XX..X...........X...XX..X...XXX..XXX....XXXX....XX.....X....X....X..
.X......X.XXXX....XX...X.XX...X..X..X.........XX.X...X...X....X....XXXX.X....XX.XX..XX.XX..XX...X...XX.
......X......X...........XX......XX.........X....XX....X....X...XX..XX..X.X...X..XX.XX.XXX..X.X.X......
X.X......XX......XX.......X...XX..XXXX....X....XX...X........X...XX....XX...X..X.....X...XX...X.X....XX
..X..X.XXX..X.XX..XXX.....XX..XXX...X..XX....X..X.XXX......X...X..X.....XXXXXX.....X...X..X..........XX
...X.X.XXX.XX...X.....X......XXXXXX...XX...X..X..........XX.....X.......X.................X....X.......
XX.....X......X...........XXXXXXXX..XX...XXXX....XXXXX...XX.X......XXX........XXXXX...X......X......X..
....X.......X..X...XXX.XX......XXX.....XXXXXX......X...XXX..X..X.......X...XX....X..XXX..XXX..X.....X.X
.X....X.....XX...X.XXX.XX..X.....X...X...XXXX....X.....X...XXX.X..XXX..X.X.....X.X.....X......X.XXX...X
...X......XXX...XX.....XXXX........X...X.XXXX..X...XX..X.......X..XX...X.....X.........XX.....X.XX....X
X..X...XX.....X..XXX........X...XXXX.XX..X............X....X..XX...X.........XX...XXX.....XXX...XX....X
....XX..X....X...X...XX..X....X..X......XX..XXX...X...X....X...X.X...XX.........X.....XX..XXXXXXXX...XX
......X.X..X...X...XXXX...XX...X...XX.X..XX...X.XXX.XXX...XX.X...XXX.XX...X.......XX..XX....XX...X.X...
...X..X.XX....X.........X....X.....XX....XXX....X...XX..X.XX.XX.........X..XXXXX.....X...X.....X.X..XX.
.X.X....X...X...X.X....XX..XXX..XX...X...X...X.......X.....X....X...X....X....XX...X.X.XXX.X.XXX....X..
.X...X....X.....X.X..X..X..X....XXXX.X...X.....X...X.....X...X..X.X......XX....X...X...XXX.X....X.....X
..X....X..XX....X..X.XX.X..X..X......XXX....X......XX.....XX....X..X.........X...X..X..XXX......X....XX
X.X.X..XXXXXXX.....X.XX.X.......XXXXXXX.....X.X.......XXX.....X....X.......X..XX....X..XXXX.....XX...XX
X..............X........X.X....XXX...XX..............XXXXXX......XXXX..XX.....XX..X....XX...XXX..X.....
.....XX......X...XXXX.....X......X.X.......X.............X..XX.........X..X.X..XX...XX..X.XXXXXX.X..XX.
.XX........X.......X...X......XX...XX........X....X...X..X......X..XXX...XX....X......X........X....XX.
.XX....X.............X.....X....XX..X...X......XX.XXX...X..XX...X....XX......X...X.......X..........X..
...X...X..X.XX....X.....XX...XX.....XXX.X.....X...X..X....X....X..XX.XXXX.XX....XXXX.......XX...XXX...X
XX...X..X.X..X....X.X........XX..XX.....XXX.......X....X.....X...XXX......X...X.XXX........X..X..XX....
XXX.....X..X..............X..XX.......XXXX....XX....X....X...XX..XXXX.......X....XX.X......X...X.....X.
XXXXX....X....X...XX..........X...XXX...XX.......XX.....X..X.X...XXXX..........X....X.X......X.XXXXX...
XXXX.....X..X...X.XX..XX...XX.X....XXX..XX..XX.X.............X.X..XXXX.................XX...XX.XX...X..
XXXX........X..XX..X...XXX.X....XX..XX.XXX..XX.....X...X..X.......XX...X......X......X...XX.......X....
..X...XXX...XXXXXX...X...X...X....X......X....X.X....X....X...X.XXX....X...X....XXX..XXX......X...XXXX.
....X.XX..XXX..X....XX....X....X..X..XX....XX...X.X.XX..X.XX..X.....X....X...X.XX....X....XX....X..X...
.........XXX...X..X..X..X...XX...XX.....XXXXXX......XXX.X....XXXX..XX.......X..XX..X......XX.X..XX....X
.....X....X..X..X....X..X..X......X......XX..X...X...XX...X..XXXX.....X...X.X....X...XX......X......X.X
.XXXXX.XX...X...X..XXX.......XX.X......X.....XXX.XXX.X......XXXXX...X...X........X......X...XXXX......X
...XX.......X.X......X..XXX..X..XX.......X...X.....X...X.....XXXX......XX.XX.X........X...X........XXXX
XX....X.....X........XX.....XX.XXX....X....X....XX....XX...X....X....XX...XX........XXXX...X...........
X.......XXXX.....XXX..XX.......XXX..X...XX....X.XX..X..X......X...XXX...XXX...XX..XX..X..X...X....X.X..
X.X..........X....X...XX.X..........X....X..X.X.XX..XX....X...X..XX....X....XXX...XX..X.XXX....X....X.X
..X...XX.XX....XX...X....XXXXXX..XX......XXXX.X.X.......X...X....X...X...XXXXX..X.X...X..X..X....X.....
.XX....X.X..X..X....XXX..XXXXXX......XXXXXXXX...X..XX...X......X...X....XXXX...XX...X.XX.X....X......X.
.....X...X.XX....XX.XX........X.........X....XX..X..X.....XXXX...XX...X..........X..X.XX.XXX....X....X.
XX.XXX..XX...XX.....XX.XXX....XXXXXXXXX...XX.....XX...XX......X..X..X.....X...X.....X..X.XXXXX.......X.
...XXX....XX....XX..X..X.....XX...X...XX.......X.XXX..XX...X..X..X..........X...X.X.XX...XXXXXXX.X...X.
....XX....XXXXX.XX..X....XX...X.X.X.X....X.......X...XX....X.X.......X...XX.....X.....X..XXXX....X.X...
XXX...XXXX..........XXX.....X.X.....X..XXX...XX....XX...X......XXX.....X.....X..............X......XXXX
XX....X........X....XX..XXXXX....XX.....XXXX....X.....XXX.X...XXXX.XX....XXX...X.....XXXX...XXXXX......
...X....X.X..........X...XXXX.....X.....XXXXX...XXX....XX.X...XX.....XX......XXX..XX..X...XX.....XX....
.X.....X..X.X...XXXX.....X......X.XX....X......X....XX......X.....X..X..XXXX...X..XXX......X..XX.XXX...
....X....XX.X...XX.........X.X..X....XX...XX.X.X.X.......X......X...X..XXXXXXX.X.......X.X.XX..X.....X.
XXX...X.....XXX.....XXXXX..X...XXXX...XX..XX...X.X.X.XXX.....X.....X..XX.........XXX...X...XXX...XX....
...X........XX..X.X...X...X....XXX..X..X..X....X...X.XXX.......X.X.X.......XX...X......XXXXX......X.X..
.X...XX.....XX....XXX...X.X.XX..XX.XXX....X....XX....X......X..X......X.......X.....X..XX..X..X.....X..
....X.......XX...X.....XX...XXX....X....X......X..XXXX..XXX...X...XXX...X.X...XX.XX...XXX...X...XX.....
X.....XX....XX.....X...XX........X...XX..XX....X....X...XXX.....X.........X.XXXX..X...X...X.......XX...
..XX..XX....XX....XX......XXXX.X.....XXX......X...X...X.X....X....X..X.......XX...X...X.XXX..XXXX......
..XX..X..X..X..XX.....XX..XX...X.XX......X.XX.X.X.XXXXX....X.....XX....XXX.X..X.........X....X.....XXXX
......X.....X...XX....XX...X.....X..X....X..X...X...X....X.X..X...X.X..XXX.XX....X...XXXX.XX.....X....X
...X..X...X...X..X...X...X...XX..X......X...XXXXXXX...XX...X....X...X.XXXX.....X...XXXXXX.X...XX......X
.XX..XX...X......XXX.X....X..........X....X..XX............X.X...........X...X....X..XXXX...XX.....X...
....XXX......XXXXXX.....X...X..........X.....XX.....XX..X..X......XX...X...X..X......XXXX......X.....X.
XX.....XXX..........X.X........XXXXXX..XXXXX.....XX.XX...XX...X...X..XXX....X........X.......X......X..
...X...X...XX...XX....X......X.XXXXX....XX..XX.X.......X.X..XX..XX..XXXX..X..X.........X...X.XX.....X.X
.X...XX..X....X....X......XX.....XX..XX........X...X.XXX...X...XXX.....XX..X.....X....X..X.............
.....XX...XXX....X..XX.XX...X.XX....XXXX...XX...X....X.............XXX...X.XX......X....XX..X........X.
XXX.....X..XX....XX....X......XXX....X...X....X.X.X......XX.....X..XXXXX.X.X....X....X....X.....X.X....
X...XXX..X.....XX........X...X....XX.X.XX.....X.....X.XX.XX...XXX.X..X...X...XX.....XXXXX..X....X...X..
X.X....X....XX......XXX..X.....X..XX......XXX.XX....X.....XXX..X..X....X....XX...XX.XX...X...X......X..
..X.......X...XX.........XXXX..X....X.X...XXX....X......X....X...XX...X.....XX.X..X....X.......X.......
...XX...X.X......X...X...XXXXXXX......X.X..XXX.....XX......X....XXX.X...X...X..XX....XXX..XXXX.XX..X...
XX.X......X..X...X.....XXXXXXX.....X....XX.....XX.XX..XX.XX...X.XX..X.XX..X...XXXXXX....XXX....XX.....X
XX...X.....X....XX...........X.....X.XXXXX....XXX....XXX....X.X....XX.XX.XX.......X..XX...X..XXX..XX..X
X........X....X....XXX..X....XXXXX...X.....X..X...X..X......X..XX...X.X..X...XXX..X.......XX.....X...XX
X.XXXX........X..X...XX...X..X.......X.......XX.X...XX.X....XX....X...X....X..X..XX........XX....X.....
..XXX..XX.....X....X.XX...X..X.X...X......X.....X....X...XXXXXXX..X..XX...XXX...XXX....XXX.....X....X..
......XX..XXX.X.X..X.........X...X....XXX...XXXXX..X.....XXXX.....X...X.X....X..X...XX.XX....X....X...X
XXXX........X.....XXXXXX...X..X.....X......X...XX.....XX......XXX...X...XX........XX......X.....X......
X....XX..XX..............X..X...XXX......X...X....X.XX..X.....X..X...XX....XX....X....X.....X.X....XXX.
..X......XX..XX....XX.....X....XX....X.....XXXXX....X...X.XXX....X.X.......X...X....X.XXXX..X.X.XX.....
.....XXX..X......XXXX.X.X....X.....X...XX........X..X.X........X.X...X.X.....X.XXXX...XX......X.....X..
XX.X....X....X.XX.......X......X.X........XXX...X...X....X.......XX....X....XX.XXXXX...X.XXXX..XX...XXX
...XX......X.X.......X....XXX....X..XXX..X....X...X.XX...X..XXX...X.X.X...XX...XXXX..X...X.....XX..XXXX
....X..X.......X.X...X...XX...X.....X....X..XXXX..X....X..X...XXX...X...X......XXX..XXX....X...XXX.....
XXX..X....X......X..X..X....X...X...X.XX.XX.XXX....XX...X..X.......X......X......X......X....X...X..XX.
...X.XX...XXX...XXX...X...XXX.....X....X......X.X..X..X..X...X.X.....XXXX...X......XXX..X........XX....
.X...XX..XXX..XX..X..XX.X...X..XXXX..X..........X.X..XXX.......X.XX...X.....X...X..XX...XXX.X.......X..
..X...XX.XXX...X..X..X......XXXXX....XX........X....XX....XX..XX....X...XX....X...X...X.X...X.XXXX.....
X.X.X..X.....X....XX...X.X...XX...XX.....X...XXX.X......X.XXX...X.......X..X.....XX.....X.....XXXX...X.
..X.XX..XX.....XX.XX.XX..X.X.X.......X.X...X...X......X.X.X...X.X.XX.XX.X....X.X.XXXXX..XXXX..X...XX...
....X...X..XX.....X..X..X....X.X...X...XX......X..X.....X.....X.X.X..X.........X.X......XX....X.X......
XX..X.....XXX.......XX....X....XXX........X.........XX..XXXX..X...X....X.........X......XX....X........
