94 96
.....X.....X..X...XXXX......XX.......X....X.....X..X......X...XXXX..X........XXXX......X...XXXXX
.......XXX.X....X...XX.........XXX...X......X...X....XXX....X...XX..X.XXX......X..X......X......
...XX........XX......X....XX.....X..XX...X.....XX...X....X.......X....X....XX..X.X..X...XXXX....
.X.XXXX...X........X.X.........X.XX....X.....X.X..XXX...XXXX...X...XX....X..X....X.X..X....X...X
.....XX.X....X.....X.X.....X...X.....X...........X..XXX......XXXXXX...XX.XX.X...XX.X.....X..XX.X
X.XX....X..X...X...X.X...XXX.....X......XXXXX.......XXXX...XXXXX.....XXX......X........X....XX..
..XX..XXX...XX.X.......XXX....X.......X.........XXX..XX..X.XXX...X.X....XX.XX.....X.....X...XXX.
...X....X.X..X......X......XX...X.XX...X.............X..XX.......X.........XX..X....XXX...X...X.
XX...XX......X..X........XX....XX....X.X.X.....X.XXX...XXX..X.......X..X.......X.X...X........X.
XXXXXX.....XXXXXX.XX.X......XX......XX.......X...X.......X..XXX...X.X........X.....X...XX.....X.
XXXX...XX...XX....XX....X.XX..........X.........XX.XX.X..X....XXX.X...X......XX.X..XX...X...X...
XXXX......X......X..X.X...XX.XX....X...XX.....X..X....X.X..X....X....X..XXX..XX....XX.X........X
..X......XXXX.XX.X....X.......X.X....X....X...XX....X.....X..X.....X...XXX...XXXXX.........XX..X
....X.........XX.X.XX...XXX.X...X.X.....XX....X..XX....X.XX.XX.........XXX...XXXX...XX.....XX.XX
.......XX.XXXXXX.X....XXXXX.XX........XX...X..X...XX.X...XX...XXXXX.........XXXXX.X....XXX.....X
.....X.XX...X......X......X..X.XXX.......XX..XX.X....X..XXXXX.........X...X...XX..XXX..XX..X.X..
.X.......XX....XX....X.......X.XX.....X..XX...X.......XX.....XX...X...X.X.XX.....X....XXX....XX.
...XX.XX.....X.X..X....X...X......X...X.....X..X......XX.XXX.XX.X...X.X.X.XX.X.XXX.X....X...XXX.
X...X.....XXXX...X..X....X.X..XX.....XX.X....X...XX......X...X..XX..X...X.X....X.....X....XXX...
..X.....X...X...XX.X..XX.X....XX.X.X....X.XX.X........X....XXX.X....XX..X...X.....X....XXXX.....
..........X...X......X.....XX....X.X......XX.......XX..XX......X....XX..XX....X.X...X...X....X..
XX....XX..XX......X....XX..........X..........X....XXX...X..XXX....XXX..X..X....X..XX.X....X.XXX
XX.....X.....X.XX...X...X...........XXX....XXX..XX...XX..X......X..XX.....XX.X...X....XXXX......
XX...X...XX....XX.....X.X......XXXX.X...XX.....XX..X.XX.X..XX.....XX..X........X.....XX.....XX..
XX......XX..X...X....XX...XXXX...XX....XXXXXX........XX...XXX....XXX.....XX.XX....X.....X......X
..XXX.X....X..X....XXXX..XX..........X...X....X...XX..XX...XXXX..XX....X.XX.....X...X.XXX....XXX
..XX..X...XX.....X...XXX..X...X............XX...X.....XX........XXX........XX......XX.X..XXX....
.....X.....X.......X.X.............XX...X.....XX....X...X......XXX.........XX....X..X....XXXXXX.
.......X.X....XXX..X.......X.X..........X..X..X..XX...X....X.....X............X..XX......X......
XXXXX....X..X...X....XX......X....X.....XX.X..X.XXX....XXX....X..X....XXX........XX..X...X.....X
....X.....XXXXX.X.........X...XXX...XXX..X...X..X....X..X...X.X....XX......X...X.....X.X....X..X
.XX.......XXX.....X.........X..XXX.....X.X...X.....X..X...XXX...XX.........X.X.....X...XX...X.XX
.....XXXXX..........XXXXXX...X.....X.X.X.........X....XX.......X...X.....XXX....X......XXXX.....
...X..XX...X.....X......X..X......XX.....XX...XX.............X...XXX...X.XX...X...X.XX.XXX...XX.
.X..X.X....X.....X.X.X..X.XX..X.......XX.XX...XX..........X..XX......X....X.....XXX......X.XX...
.XX...X.X..XXX...X...X.X..XX..X..X.X........XXXX..X.......X.XX..XX......X.X....X....X......XX..X
.....XX.XXXXX..XXX.......XXX..XX...X.XX...XXXXXXX...XXX......X...X..X.......X....X....X.....XX..
XX....X.......XX......X...XXX...........X..X.......XX....X.X.XXX..X......X....X....X..X.....XXX.
....X..X...XXXX...XX....X.......XXX.X....X...XXX.X.X..XX...X......XX.......X..X...XX....XXX...X.
....XX...X...X..X..X.X.....X........X..X.....XXX...X...X..XXXXX.........X..X....X....X...X..X.X.
...XXXX..XXX...XXX...X...X.....X...X...XX......XX......XX.......XXX.X.....X..X..X..X...X...XX...
.X...X...XX.....X.....XX..X......X...X......X.....X............XXXX....X..X.XX..XX...XXXX......X
.XXX.X...XX.XXX...X.....X.......X......X......XXX......X.....X....XXXX...X..XX..XX.XXX...XX.XX.X
..XX......X......X.......X...XX.X.XX.........XXXXX..X....X...XX.........XX......XX..X..X....X..X
X..X..X...XXXX.X...X...X.X.XXX..X.......X.....X.....X.X....X.......XXXX....XX...XXX...XXX..XX.XX
...XX........X.X.XX..X.....X...X....X.....XXX.X...X.....XX...XXX.........X...XX..XXX..XXX..X..XX
...............X..X.....X........XX....X......X.....XX......XXX........X..X..X...XXX..X....X.XXX
XXX..X......X...X...X.....XXX...XXXX.....X.......XX.......X.....X..XXX.XX.X.XX........X.XX......
..X....X....XXX.XX....XX......X................X...X..X...X..XXXX...XX.XX.X.........X.......X...
....X....X....X......XX..XX...XX....X.....X........X..X.X....XXXX...XX....X..X......XXXX........
......X....XX...X.X..X..XXX..XXX.XX...X.......X.X.....X......X..XX..XXXX...X.......XXXX....XXX..
XXXX....X....XX...X.XX...XXX...X..XXX....X.X..X.....X....X......X...X....X......XX......X.....XX
..XX...XX.XX.....XX....X........X......X.X...X...X..XXXX......X...X.....X...X.......XX....X.X...
..XX...XX....X....XX...XXXX...X.X......X....X..X.X...XXXX.X.....XX........X..XXXX...XX...X..XXX.
...X.....X......X......XXX..X.....X.......X.X......X....X.......X..XX..X...X...X..XXXXX....XX...
.X.....X......X...XXX....X.......X....X.......X.......X...XX......XXXX...X..X....XX.....X...X.XX
.XX....XXXX...XXX.XX..XX...X...X...X....XX.XX.....X.X.....XX.....X.....XX...X.X...X..X....X....X
......XXXX..X..X.....X......XX.X...XXX.....XX..X....X.XX.....X.....XX..X..X.......XX...X.....X..
..XX.....X...X...X.....XX.X..X......X..XXX..X....X.......X....XXX.....XX....XX.XXXXX.....XXXXXX.
.....XX....X.XX........X..XX...XX.X...XX....X.X...XX...XX...X.....X.X.....XXXX............XX..X.
.XXX....X.......XXXXXX.X........X....XXX..X.....X....X....X..XX...X....X..XX...X...XX.....X...X.
..XX.X......XXX........X....X.X.XX....XXX.X..X.XX..X.....XXX....XX...X...X...X...X.XX.X.....X...
X.....XX.....XX.XXX...X..XX.X......XX.....X....XXX....XX.XX....XX..X....XX............X..X....XX
....X.....XX........X...XXX..X...X.....X....XXX..X..X.......X.....X...X.......XXX...XXXX...X...X
.X...............XXXXXX...XX...XXXXX.....X.......XX.....XX....X.....X...........X....XXXX..X.X..
...X.....X.........XX..............X.XX.XX.....X.....X...X...X...X....XX..XX.X....XX.X..X.X..XX.
X..X...X....XXXXXX.....X...XXXXXXX......XX..XX.XXXXX...X.X.....X...X..XX...X...X...X....X...X...
...X......X...X....XXX.......XXXX...XXX......X.........X......XX..X..XX..X....X..X...XX..XX...XX
.X.XXXX.XXX.....X..X..XXX.XX......XXX...X....XX...X....X..X....XX...XX..XXX.....X........XX.XXXX
.X..XXX.XXX....X..XX...X..XX..........XX..XX....X.....XX..XXXX.........XX...XX....X.............
.XX...X.XXX..X...XX..X...X...XXXXXXX..X..X.....XXXXX...X..XX.....X...X......XX...XX........X....
........XX.......X..XX..XX..X....X....X.....XX....X..X.X...X.XXX...X...XXX.....X....X...XX.....X
XX...X...X..X......XXXXXXXX...X..X....XXX...XXXXX.X......X...XXX..XX..XX..XX.X....X...X.....X..X
X..X...X..X.XXX.........X....X..X......XXXX...XXX.....X............XX..X...X....X....XX..XX...XX
X.....XXX...XX..XXX...X....X...XX.XXX....X....XXX..X....X.....XXXX.XXX...X..XXX....X.XX..XXXXXXX
..X.X.......XX..X...X.XX...X...XX.....X....XXXX....X..XX..XX..XX...X..X..XX.....XX....X.........
....XX......XX....XX..XXXX.....XX....XX...XXXXX..X..X..X.....X...X.......XX..X......X...XX....X.
...X...X.....X.......XXXX..XX..X..X..XX....XXXXX.XX..X.XXXX..X........XX..XXX..X.....XX.....X.X.
.XX....X...X....XXX.....X.....X..X..XXX....X...X.....X...XXXX...XXX...XXX.....X......X..X.X.X...
.XX.X....X....X..X..XXX.X...X...XX.XXX..X....X.X..XXXXXX......X.XX....XX...X....X......XX...XX..
....X......XX..X...XXXX.X............X......X..XX..XXX.............XX..X.X.....XX.....X.....X...
XX....X.X....X..X..........X......X......XX.X.XX...X...XXXXXXX.X.......X.X..XXXXXX....X.....X...
........X.X...X...X...XX.....XX.....X.X.....X....X.........X...X....XX...X..X........XXX.....XXX
.......XX.X.X..X....X.XX..X.X...XX..X.X..XXXXXX.........XX.X.XXXX...XXX...X.....X.X..XXX...X.X..
XXXX...XX...XX.X.......X....X..XXX....XX..........X...X..X...X..........X....X..X...XXXXX..X....
X..X...........X.....X...XXXXX.XX..X...X..X....X....X....X.......X.XX...XXXX...X..........XXXXX.
X..........XX....XX...X.....X.....X..X.XX...XX....XXXXXX.X.XX.XX...X......X....X...XXXXX........
X...X....X.X..XXX...X.....X...X.....XX.XX...XXX.X.X...X..X.X..X...X..X.XX.X....XXX.XXX...XX.....
X.....XX.....XXX.......X..XX.....X...X.XX...XXX.X...X.X....X....X...XX.XX.X......X.....XX.....X.
..XX...XXXX......X...X...XX....X...X.X........X..X....XXX..XXX..XXX....X..X......XX....X...X....
..XX.X......XXX....X.....X..XX.......XXX...XX.XX......X..........XX.X..X...X.....XX..X...X...X.X
.....X..XXX.XXX.XX.XX....X.XXX....X..XX....XX.X...X...X...X...XX....XXX..X...X...XXX.....XX..X..
.XX.....XXX.....X........X..XXX......X..XX....X.XX....XXX.X.X.....XXXXX........X......XX..X.....
....X.............X......XX.....XX...X.....X..X....X..XXX...X..XX.......XXXXXX........XXX.....XX
