15 16
........X...X...
....XX..X.X.....
..X.XX.X.....X..
..X......X......
........X.......
...X....X.......
.XXX....X.....X.
........X.......
X...X...X....X.X
X.X.XXX...XX.X.X
..X....X.....X..
.XX....X..X...X.
......XXX...X...
...X....XXX....X
.X...XX........X
