107 109
...XX..XX...X.....XXXXXXX......X.............XX.....XX.........XXXX........X.....XXX....X...X...X..XXX..XX...
.X.....XX.X....XX..XXX....X..X.X..XXX.....XX....XXX.XX..XXXXXX.XXXX....XXX.X.XXX.XXX.XX.....X.X....XX...X..X.
.....X.......X.....X......X..X..X.....X.........X...XXX........XXXXX...XXX...XX..X...X...X..X....X....X...X..
..X......X.XX...XXXX..X...X...X.XXX......X......X....XXX.......X..XX...XX...XXX.X......X....XXX......X..XX..X
X...X.XX...X..X.......X.....X.X.......XX.....X..XXXX.X.......X.X..X.......X.XXX.X.X...XX.XX.X...X.X..X..XX...
..XX..XX.....XXXX...X....X.........X......XX.XXXXXXX....X....X....X.X.X.......X.X...X.......X.....X.XX...XXX.
.XX..X......XXXXX.X.XX...X..XX.......X.......XXXX..XXXX...X.....X.....X..X......X....XXXX......X.......X...X.
..X.......X.......X.X....XX......XX..........XXXX.....XX......X....X..XX...X.XX....X......XXXX....XX....X..X.
X...X.....X..X........XXXXX..X.....XX.XXXXXX....X...X....X.X...XXXXX..XXXX.X.......XXX....XX....X....XX...X..
XX......X..X...X...X....XXXXXX..XX.X..XXXX..X...X...X..X.X...X..XXX...X....XXX...X.....X..XX.......X.XXX....X
XX.X.X.....X..XX.X......X.......X....X............XXX........XX.....X...X..XX....X.XX....XX..XXXXX.......X...
XX.X...X...XX.XX.X..X...X...XXX...X..........X.....XX...X....X...X..XX......X.X.....X.XX.XX.....X...XXXX...X.
...........XX..X....X.X..X........XXX.X........XXX.XXX....X....X..XX.....XX.X...X.X.X.......X.....X...X....X.
.XX.....X....X....X......X.X.X......X...X.......XX.X.....XX...XXX..X.....XX.....X.....X...XXX..X....X...X..X.
......X...XX....XX..XX.......X.XXX...X....X...X....X..X.....X...XX....XX.XXX...........XX....X....XX....X....
X.........X...X....XXX...XX....X...X...X....XXX.....X...X.......XXXXX....X....XX.XX..X.....X.X..X....X....X.X
..XX...XX.X.X.....XXXX.....XX..X.XXXXX...X.X......X..XX....X.XX.............X....XXX....XX.X.X..X..X...X....X
.XXXXX......X........X..X...X....XX....XXX...X.X..XX.....X.X..X......XXXXXX..X..X....XX......XXXXXXX..X..XXXX
.X.....X.........X...X....X.XXX.....X.......XX...XX...XX......XX........XXXX....X.X..X....XX..X...XXX.X...X..
.X.X...XX....X.XXX.....X....XXXXXX..X.X..X......XX..X.....X....X..X...X.......X...XXX..XX.....X.X.......X....
...X..XXX.X..X..X...XX....XXX..X...XX....X.X.XX....XX..X....XX..X...X....X.......XXX..X.....X...XXXX.XX.XX...
XXXXX.....X.XXX...X.....X......X.X.X...X.....XXX....XXX..X......XX..X..X.....X.X.....X...X..XX..XX...X.......
.......X....X.........X....X.....X...X.XX...X....XX...X.XX...XX....XX.....X....X.......X...X....XX.X...X.XXXX
....XX.....X..XXXX.......X......XX..XX..X.....X...XXX......X......XXX...X...X.......X......X.XX..X.....X...XX
..X.....X..X.X.......X.....XX....XXXXXX.........X.X....X...XXX.XX.XX..XX......X.XXX.X.X......XXX.........X..X
.....XX...XX............X....XXX..X......XXXX.......X..X.XXXXX.XX.X..XXX.X.XX.X...X...X.X...XX....XX......X.X
...X......X...X.......X...X.....X........XX...XX.X.....X.......X....XXX..X..X.....X..X..XXX.............X...X
X......X....XX..X...XXX.....X......X.........X...X.X...XX....XXX.X......X...XX...XX....X...XX.........XXX....
X...X....X.....X..XXXXX..X.....X.XXX.X.....X...X.....X.XX..X.X.....XXX....X....X....X..X.X.X....XXXXXXX......
XXX...X.......XX.....XXXXX...X.X..X....X......X...X..X..XX.X..........XX....X......XX..X.....X....X......X...
........X.X........X.X...XX..X.XX...X....XXXX...X...XXX...........XX....XX..X.X.........X......XX...XX...X.X.
.X....XX..X....X...X...X.....X.XXXXXXXX.....XX.....XXX..XXX.....XX...X......X.....X.XXX....XX....X..X....X.X.
...X.....X.....X.XXX..XXXXXX...XXXX.....X...X....X.XXX...X...XX.XX.....X.......X....X....X.XX....X..X....X...
.....X.....X.XXX..XX........X.....X.........X.XXXX...X.X...X....X...X.....XX.....X.......X...XX.....X..X....X
....X..XX..X..XXX....XXX......XX......XXXX..X.XX..XX.X..XX....XXX.X...X.X.....X....X.....XXX....X...X.....X..
....X.XX......X....X.......X...X.X.XX.......X.....XX..X..X..X.........X..X....X.XX.....X......X...XXX...X....
..X...XX....X......X....X....X...X..X..X......XXX...X....XX........XX.XX....XX..XX..X.......X.........XX...XX
..X..X...XX...XX.XXX......X....XXXX........X........X......XXXXXX.....X...X.XX...X..X...X.X........XX....X..X
XXXX...X.....X...X.....X....X.......XXX.XX...XXXX.....XXXX..X......XXXX..........X..XX..X....XXXXXX...X..XX.X
....XXX...XX...X.........X....X.......X..X....X......XXXX...X....X.....XXX.X.....X..X..XXX.X....X.....X..XX.X
.XX..X..X.........X...XX...XX...XX.....X...XX....X...XXXX.X..XX..XX........X.XXX..X...XXX..X.XX...XX..XXX...X
...X...XXXX.....X.X...XXX.......XX...X.XX.....XX...XXXXXX....X...X..X.X...X.......X..XXXX......X.......XX.X..
X..X..XXXXX.........X.....X..X.....X...XX.XX....X...XXXX.....X.X.X.XX...X...X......X........X..XXX.XX..X..X..
X.XX......X......X........X....X......X...X..X....X...X..XXXX....X...X........XXXX.XXX...XXXX.XXX..XX.XX.....
X.X..XXXX...XXX....X.XX.....XX......X...X...XX...XX.....X.....X...X......X.......X...X.X...XX...X.....X..XXX.
X...X..XX..XXXX.X....XX....XX...X......XX...X..X.....X....XX....X.X.X......X...X...X.......X....X..X..X..XX..
XXX....XXXX.......X...X..XX...X...XX...X....X....X.......XX..X..X..........X.X......X...X....X..X....XX.....X
....XX...XX....X.XX.X....X.........X.....X....X....XX.X..XX.XX.XXXXX.X..XX.X.X.XX.X...X...X..X....XX....X....
...XXXXX.XXXX....X.......X.X.......XXXX...XX....X..X..X.XXX..........X..X..X....X..XX......XX..X.............
.........X....X....X.XXX...X......XXXX..X.XX.X....XX..........X.........X.X...X..X..X..XX..X..X..X..XXXX.X...
..X....X....XXXXX....X.....X...X....XX.......X.X.......X...XX....XX..XX.....X..X..X....X..X..XX.XX.....X...X.
..X..X.X..X....XXXX....XX..XXX...X.......XXX.....X.......X.....X.XX....X...X...XX....XX..XX.XXX.X..X......X..
XXXX.X....X..X......X..XX..XXX..XX.........X.XX.XX...XXXX....X......XX.XXX.X.X...XX.....XXX.XXX...X.........X
.....XXXX.XX..X...X...X....XXX........XXXX...XX...X..XXX..XX....X........X.....X..X...XXX.......XX..X....X...
...XXXXX..X...X.X.X.....XX.....X......X...X..X..X...X....X....X.XXXX..X....XX.....X....X..XX.......XX......X.
XX....XX.XX.X.X.X....XX...XXXXXX..XX..X......X....XXX.XXXX..X......X....X..X..XXXXX..X.X.......X..XXXXX.XX...
XXX....X..X.X......X....X..X..XXX...XXX..X.X...XX.X...XXXXX....X.....XXXX.XX.X....X..X.......X..X.....X.....X
.....X.XX......XXX.....XXX.X....XX....X....X....X...XX.......X...XX.XXXXX....X......X......X..X...XXX.X...X..
.X...X.......X......XX...X...X..XX.X....X....XX.X..XXX..XXXX......X....XX..XXX...X....XXX..XX..XX...X...X....
.X...XX........XXXX.XX......XX.XXX...XXXX...XX..X..X..X...X.....X.XXXX.XX..XX..X...X......X....XXX..X..X.....
.XXX....XXXXX..XXX..XX....X..X...X..XXXXX...X..X...X....X...XXXXX.XXXX......X.XXX......X....X......XXXXX.....
..X.....X........X...X....XX..X......X..X.....XX...X.XX..XXXXXXXX..X........X.XXX..XX....X........X..XXX....X
X...X.....X...XX...X.....XXXX.X.X.XX.X..X......X..X..XXX......X..X...XX....X..X..X....X..XXX.X....X......XX.X
.......XX...X..X....X.....X...X...X..X..X......X....XX....X...X.....XXX.X....X...X..XXX.XXXX.....X..X...XXX..
.X...X....XXXX....X.X...X...XX...X..XX.......XX..X...X..X.......XXX..X..X.X....X..X...X.XXX...XX...X..X.XXXX.
...X...X..XX...XX.....X....X...X...XXX...X......XX.X....X.XX...XXXXX...X..XXX..XX...X.X..X..XXXXXX...XX.XX...
..XX.....XXX.X.XXX...X..........X...XX......X....X....X.X....X..X.....XX.XXXX.........XX...X..........X....XX
...X..XX.X...X...X.XXX.X......X...X..X....X....X..XX..X.XX....X...X.X....X......X...XXXXXX...XXXX...X...X..XX
.X..X......X.......X.....XX...X..XXX...X...X......X..XX.XX..X.....X...X....X....X.X..XX........XXXX.......XXX
..X...XXX.........X...X..XX.X.XXXXXXX....X....XX....X...X...X..XX..X..X.......X......XX...X.XX.....XXX.XX....
X.XX......X.....X...X....X....XXXXXX..X.......X..X....XXX.X..XXXXX..........X....X....XX..X...X........XXX...
..X..X....XXX.X....XXXXX...X.XX......XX...XX..X.XXXX.XXXX....XX...X...X..X...X...XXXX.X..XXXX.......XX.......
.XX.XX.XXXXXX....X..XXXXX....XX.XXX.....X.....X.XX...X.....X....X...X....X.X...XXXX...X.XXXX...X....XX...XX..
....XX.....X.....XX.......X.......X.X.........X..X.......X...X..XX..XX...X........X..........XX...XXX........
.....XXX...X.......XX..........X..X....X......XX...XX.X......X..X........XX...X........X.XX.....X.X...X.X....
...X...X..X...XXXX......XX.......X...X.XXXXXX.XX......X.X.......X....XX..XX.X....X.......XX...XXX.......X.X..
XX...X..X.X.X....XXX.......X..X....XX..XXXXXX.......X...XXXXX.X.XXXX.....XX..X...X.XXXX....X.......X........X
..X.....X.X.XX.....X...XX..X..XXX.....XXXXXXXXXXX.......XX....X...X...XX...X...X...XX....X...X.XXX.X..XX.XX..
......XXX.X..X..X....X....XX....X..XXX...XX..........X..XX.XXXXX....X..XXX.XXX.XX.....XX.XX....X......X..XXX.
...XX..XX....XX...XX.X...X...XX.X......X..X.XX..XX......XX...XXX.X...X.XXX.X......XXX.......X.....X.....X....
....X..XX..XX....XXX...X...XXXX...XXXX..X...X...X..XX...X....XX......X.....X.XX.....X.XXX.....X.X.XXXX....XXX
XXX....XXXX....XXXX.........XXXX...XX...X..XX.X...XX...XX.......X.....XX.........XX.....XXXX....X..X...X.....
..XXXX....X..X.XX...XXXXXXX..X...X....X....XX....X...X...X........XXX.XX.XX......X..........XX...X...X...XX..
....XXXXX..X.X....XX....X....X..XX...XXXXX...X.....XXXXX...X...XX.....X..XX.....XX.....XXXX....X....XX......X
.XX......X.....X.....X....XXXXX....X...X.....X.XX.......XXX..X.X...X....XXX...X......X..XXX..X....XX.......XX
..XXXXX.....X....XXX...X....X..X..XXX..X........X.....X.XX..XX...X...X......XXXX.....XX...X.....XXX.....XX.XX
X...X...X.X...XX.....XXXXXX....X..XXX.X.......X...X...X....XXXX......X...X...XXX.XX.......X...X.....X........
..X....X..X......XX.....X......X..XXX...XX.......XX.XXXXX..XX...X......X...X.XXX.X....XXX..XXXX..X....XXX.X..
.....X...X......XXX...X...X.......XXXXX......X.X..X........XX......XX.....X..X...X....X....XXXXX...X....X...X
......XXXX.X......XXX....XX.....X.....X.X.X..X....XXX...XX...XXX.X.XX...X.X.........X......X...XXX.X.XX..X...
XXXXX..X...X...X.......XXXXX....XXXXX.....X.X...X.X...X..X....XX....X...X...X...X...XXXX...X.X.X.....XXX...X.
.....X.......X...XXX...X.......X..X...XX......X...X.XXXX....X...X.X...XXXX..X...X.XXXXX..X...X......X...XX...
.....XX...X.....XX...X...XX.XX.X....X..XXX...X...XX.XXX...XXXX....XX.....X.X....X.XXXXX...........X...X......
....XX....X.X.XX...XXXX...X......X...X.....X...X..X.....XXXX...X.....XXX.X...X....XXXXX.X.....XX..........X..
.XX....XX...X.......X...X.....X.X..X..XX.......XX.XX...XXXX......XX....X....XX.X..X..XX.X.XXX......X.XX.....X
.....XX........XX.X.X......XX.X...X...XX.XX....XX....X......X.............X..X....X...X.........XX.X.X..XX...
...X.....X...X.XX......X...XX.XXXXX......X..X..XXXX........X..X...XX..X...XX....X.X.X....X...X.......X.XXX.X.
.X.....X.X...X..XX.X...XXX............X..X....XXXX..X......X....XXXXX...XX..XXX.....X..X...X...XX...XX.....X.
....X....XXX..X..X...XXXX....X.....X....X..XX.X..X.XX.XX..XX.....X......XX..XXXX.XX..X.....XX.....X..X..XX...
X.....X..XXXX..X.....X....X..X.XXX...X....XX..X..X.XX..X...XXXXX...X....XX.....X.X...X.XX..XX...X..X..XX...XX
..XX..X..XXX...X..XX...XXX...X....X....X...X.XX....XXX...X..............X..X...X...X...X...XX...XX.XX..X..XXX
....XX.....X....XXXX..XX...X..X.....X....X......X...XXXXXX..X...XXX.....X.XX.XX...X...XX.X....X....X...XX....
.......XXX...XX...XXX.......X......XX...X..XX.XXX.X..X..XXX...X.....XX..X..X....X.X.X....X.......XXX.....X...
.....X.......X....X...X...X.XXXX....XXX.X..XX.XXX.XX....X...XX.........XXX....XXX...XXXX...XXX.X.X...XXX.X..X
...XXX...XX....XX.........X.XXX.....X...X.....X...X.....X...XX.XXXX..X.XX...XXX....XX....XX....X...X...X.XX.X
...XX.......X...X.XX...XXX..XX..XXX.....X...X.....X.........X..X...X...X..XXXX...X....X.....X...XXX......X..X
......X.......X...XXXX.....XXX......XX..X.....XX..XXXXXXXX..X....X...XXX.......X...X..X.......X.....X......XX
