93 94
.....X.........XXXXXXXX..............XXXXX.....XX..XX..X....X.........XXXX.......X..XXXX......
.X...X......X......XXXX.................XX.X...XX...X....XX...XXX........X.XX....X..X....X....
....XX....X...X.XX....X.....XXXX....X.X....X..X...X...X......X.......X.X.X.XX..XXX....XX.....X
X.X....X..XX..X..XX.....X...XXX..X..X..X....X.X.XXXXX...XX...X...X.X...X.X.XXX.....XX.....X..X
..X..X...XXXXX...XX.XX.XX.XXXX..XX.XXX....X...X...........XX..XX...X.......X..XX........X...XX
.XX........X...XXXX....XX....X.....XX...X....X..X...XX........XX..XX....X.....XX.XXX.......XXX
....X...XX...XX..XXX.....X.....XX.....XXXX...X....X.XXXX...X...X..XXXXXXX..XX.X........XXX....
...X..X..XXXX....X.....X........X......XX......X.....X...X...X.....X..XXXX..X...X.XXXXXXXXX...
.X.X...X..XXX..X..........X...X.....XX....X.X....X.X...X...XXXXXXX.......XX.XX..X...XX........
.X...X....X..X....X...X.....XXX..X..XXX..XX...X..X....X...........XXX....XX..X......XX.....X..
.X....X......XX...X......X....X....X..X...XXXX......X...X...XXX...XX..X..XXX...X......XX......
...XX....XXX......X....X....X.....XX....X......XXX....XXX.......XXXX.....X..........X..X..X.X.
X...XX.X.....X......X..XXX..X..X.....XXXXX....X....X......X..X..XXXX...X....X...XXX.XX..X.X...
..X....X..XX...X...X...X...XX....X.........XX...X......XX.X..X.......X.XX.X...X.....X...X.XX..
.X...X....XX...XXX...X.X.XX...XX...XXX.....XXXXXXXX....XX.X...XX..........X..XX...XXX.........
...X......XX.....XX..X.X..X............X...X..X.....XX..X...X..X......X....X...XX........X.XX.
XXX.....XXXX..XX.XX....XX...XXX...XXXXXX...X....X.....X.X..XXX...XXX..XXXX...X.....X.......XX.
XX..XXXXXXXXXXXX....X...X......XX...XXXX.....X.....X..X.......XX.....XX......XXX........X.....
XX..........XXXXX...XXX.X..X...X....XXX...XX...X...X.X........X.....XX..XXXX...X....X.X.XXXXXX
..XXXX......XXX.....XXX........X........X.XX.....X.....XXX...X..X.X..X.....XXX.XXX....X.......
....X..X....X...XX..XXXX....X..X........X.X...........X....X...XX..X....XX.XXX...X.....X......
....X.X..XX......X..XXX..X....XX...X....X.X.X...X...XX..X..........X..X....X.......XXX.......X
......X.XXXX...X.X..XXX....XX.X..XX..X..X.....XXX.X....XX...XX..XXXXX....X......XX....X...X..X
...XX........X.....XXX..XXX.....XXX.XX....XX........X.....X...XXX.....XX...XX....XXXX...XXX.XX
....X..XXX...........X...XX.........X..X......XXXX...XX.X.....X...X..X....XXX..X..X.........XX
XXX.........XX....XX...X.......XX..XX....XX........X..............X....X..X..XX...X.XX.....XXX
...XXX....X.....X.XX......XX.X..X...X...XX.........XX....XXXXX......X..X.XX.....X......XXX...X
.X.XX..X......X.......XXX.X..XX...X...X....X.....X....X...XXX....X.....X....XXX....X...X......
......X..X.....X....X...X...XXXXX..X..X.X..X...X.....X..X.....XX...X...XX.....X..X...X.X....X.
X...X...X....X....X.....X..X.......X..X.X..X...XXX.....X.......X.XX..X.....XX.XX...XXX....X...
..X.......XX.XXXX....X.....X....XX....X...X.....XX.XX........X...........X..X........X..X.....
...........X.......X...X...X..X..XX...X...X...X.......X.X.......X.....XXXXX...X...X..X....XX..
XXXX.......XXX...........X.....X.XXXX......XXX....XX..X.....X.....X.X....X........X.X..XX.XXXX
XXX..X.X.......XX............X........XX.X...X.XXX...X...X..XXXX....X..X...X..........XXX.....
XXX....X......XXXXXXX...X.......XXXX.....X.....X....XX.X...XXXXXXX...X.XX..XXXXXXX...XXXXX....
XXX...XX..XXX.XXXX..XXX..XX...XXXX...X.XXX..X.....X.X..X..XXXXX...XX...X...XXXXX...X..X....X..
XX..XXXX..XXX....X....XX....XXXXXX...X...XX...XXX...X...X.....X.X..XX..X...XX..X......X..XXX..
X..XX...XXXXXX.....X.....................X....XX......X.........XX...XX...XXX...XXXXX..X......
X...X................X.X...X.....XX...XXXX.X.....XX......X..XX...X......X.....X...X....XX.....
..X..X........X...X....XXX...XX..X..X..XXX...X.......X...X.....X.X....X....XX.......X..XX.XX..
..XX......X.....X.X......X......XX.....XXXX..X.....X....X..XX....X..X......XX......XX..XX.X..X
....XXX......X....X......X.....XXX...X......XX.X......X...XXX.X...XX.....X.......XXX...X..X...
.XX...XXXX.X......X.........XX..X..X.......XX..X.XX......XX.....X....X...X.X.....X...X...X..X.
......XXXX..X..........XX.XXXXX.X.......XX....XX.....X.......X..X...X..X...X...X.....XX....X..
..XX......X....X...XXX.XX.XX..X..XX.....XX..X.....XX......XX...XX.X.X.....XXXX...XX..........X
..X..XXXX....X...X........X...XX......X...X...X.X.....X...XXX...X.....XX......X..X....XX.XX...
....XX..X.....X..XX...X.....X.XX..XXX...X...XXX.....X....XXX..X..X.......X.........X........X.
.X......X..XX.X.XXX.X....X..X..XXX....XXXX....XX.......X.XX..XXX.X...X..XX..XX....X..XX.XX....
.X..X...XX....X.....XXX.....XX..X..X..XXX.......XX........X....X...X.X...X......X.X.XXX..X...X
..X...X..X..X....X......X.X.....X.XX......X..X........X.X....X....XX...X...X....X........X...X
X........XX....X...XXX..X....XXX.....X...XX..X.X.XXXX...X..X....XXXXX...XXXX.......X..........
..XX........XX....XXXX....XX.....X.....X.....X...XXX.......X..........X..XXXX..X...XXXXXX...X.
.........X..X...X...X..X.....XX.....X......X....XX...XXX...X.XXXX....XXX..X....X.XXXX..X..X...
.XXXXXX....XX.XXXX..X....X......X.....X.XX....XX.........X........XX...XX...XX.....XX..X.XX...
..X.....X...X.XXXX.X..XXX..XX.XXX.XX....XXX...XX..X.X...XX....XXX..XX..............XX....X....
X.....XX..X...X......X....XXX.XXX....XX..X..X.XXX.X...X.......X....X..X......XX.......X....X..
...X.....XX..XX...X....X......XXXX.......X.XX...X.XXXX......XXX..X...XXXX..X....X.......X...XX
.XXX.X....X...XX..X...XX.XXX...X....XX...X....X...XXX..X.....XXX.XX...XXX...XXXXX....X....X..X
..XX....X...X.....X....X..X..X....X....X.XX.......XXX.....XX........X.....X.......X..X...XXX..
X..X..X...........X..X..X...XXXXX..XX..X.......X..XX....X...X...X..........XX....X..XXXX...XX.
...X...XX....XXXXXXXXXX.........XX....XXXXXX.....XXX.XX.......X....X....XX....XX...XXXX..X..X.
.XXX.X.....X....XX.......XXX......XX.......XXXX......X.....X...XXX.......XXXXXXXXXX...X.....X.
.XXX.XXX.X...XX..X...XXX.....X.XX....X...X...XX...XX...X.X...X..X...X..X....X...........XX....
.X...XX..X.....X..X..XX......X..XX.....X.X...XX....X...X.....XX...X.......X.X.XXX....X.X.....X
.....XX.....XX....X.X...X....XX....XX..X.X.....XXX.....XX........XXXXXX.XXX...X...X....X..XX.X
X....XXXX...XX........X.....XX........X..X..X..X.......X............X...XXX..XX.XXX.......XX.X
..X..XXX....XX.....X.X...XX.X..XXXX...X.......XX.XX......X......X.X...XXXXXX....XXXX....X....X
.....XXX.X...XXXXX.X.X.X....X...X.....XX.........XX.XXX.....X.X...X....XX.....XXXXXX......X..X
...X...X...X..X....X........XXX...XX..X..X...XXXX...X.....X...XXXXX....X..X.X.X....X...X...XXX
.XX.......X...X...X...XX....XXXXXX....X....X...X....X.XXX....X..XXXXXX...XX.....X....X.X.X....
....X...X.X....X....XXX..X..XXXX...XX...X..XXX...X..X.XX.....X..X..........X......X......XX...
...XX.XXX...XX...X....X.XXXXXXXX........X.......X...X....X.X....X.XXX......X.....X....X..X..XX
.X..X........XX...XXX...........XX...X....X.....X.....X..X....X.......X........X...XX....X.XXX
.XX.XX..XX.X....X......XXXX........X...XX......XXXXX.....XX.X..X.XX.......XXX.....XXX..X......
..X..X.....XXXXXXX........X..X........X....X...XXXX..X...X..XX.X..X.XX........X....XXX...XX.X.
X..X...XX....X......XXXXX.XX........X..........XXXX....XX..X....X...X......X..X....X........X.
...X.......X......X.....X.....X........X....X....XXXXXXXX.....X....X..XXXX......X....XX...X...
.X.....X.X....X...X..XX.....X.X....X..........X............XX.XX...X...X....X.....X..X..XX....
....X....XX...X.X..XXXXXX.....X.......X....XX.X.X.....XXXX.XX.X....XXX....X....X..XXX..XXX.X..
X...X.X...X.X......X......XX....XXX.X...XX......X.XXX..X......X.X..XX...X....X.X......X....X..
XXX....XX.X....X..........XXXX......X......X...XX..XXX...XX.....XXXXX......X.....XX..XX...X...
X....X.XX.XXXX.XXXX.X.....XXX..X.........X...X..XX......X.........XX...X......XXX....XXX..X...
X.........X....XXX..X.XX......XX....XX...XX.....XXX.......XXXXXXX....X.XXXXXX......X..XX.XX..X
..XXX...X.....XXX..X..X..X...XXXX......XXX..XXX..XX....X...X.......XXX....XX.....X.XX.XX.XX...
......X....X..X...XX.XX....X....X..X.......XX....XXX.....X.........XXXX......X.....XX.......X.
...X.....X...XX......X.....XXXX....X.XXXX.....X......XX.....XX.....X....XX.....XX.........X...
.....X.X.....X...XX..X.....XXXXXXX........X.....XXX..X..X....X.X...X.X....XXX..XX...X...X...XX
XXX..X....XX.X.X......X...XXXXXX....XX....XXXX.......X....XX...XXX.....XX.X...X...X...X......X
X.....X...XX.X....XXX...X.X....X.XX....XXXX....X.....XXX..X....X...XX.......X.X.X...XXXX...X.X
..XXX...X....XX....XXX....X.XX...X..X.......X.....X..XXX..X....X.X.X.....X......X...XXXX...X..
.XX..XX...X..XX....XXX...XX.....XX.XX.X.....X.X.X.X..X....X...XX.X...XX....X...X....X......XX.
.X...X.......X..X...XXX..X....X....X..X.X...X.X...X..X......X....X..XXX.X..X.XX..X..X.XX...XX.
...X...X.....X....X.....XX......X..X....XXX...XX..X..XXXXX..............X..X....XX..X....X....
