113 115
XX....X..X....XXXX.......XXX........XXXXXX.....X...X...XX.....XXX...X..X....X......X...XXX....X...XX...X......XXXXX
XX.XX.X....X..X....XXXXX.....XX..XX......X.....X.X...X.XX.....XX..X.X....XX.X........X.X...XX.X.X....X...XXX.......
X..XX.X...X..XX..................XX......X....X..X......X....XX..XX...XX....X....XX......XXXX...X............X.XXX.
X...X...X...XX...XXX....X....X...X.....XXX.XX...XX....X...X.....XXXX.....X....X....XX...X..XXX....XXXXXXXXX....X...
....X..X.......X.XX..XX...X..XXX...X.X..X..XX............XX.X......X.XXXX..X....X..XX..........X..XXXX..X...X......
.XXXXXXX.X.XX.......X.......XXX..XX..XX...XXX........X....X.....XX...XX...XX...XX......X......X....XXX....XXX.X....
.........X....XXX......XXX....X...X...XX...XXXX...X.....X..X....X..XXXX....X...XX.XXXX.....XX.X.XX.....XXXX...XXX..
XX......X......X.....X.....XX...X...X....X......X...X......X...XX...X......X....X.......XXX...X.....XXXXXXX..XXX...
X..XX.....XXXX...XXX....XXXXXX.......XX..X.....XXX..X..X.X..X..XX.X...XXX.....X.XX....X..........XX....XX..X...X...
X...X..X.....X....XX..X.XXX....XXX.X....XX...X.....XX..X....X.XX..XX......X........XX...X..X...X....XX.....X......X
..X..X.....X...XX...X.X..XX.X..XX..X..X....X....XX.XX.....X....X.......X..X..X......XX..X....X....X.XX...X....XX..X
...X....X........XX...XX....X..XX.XXXXX..X...XX.XX....X......X....X......XX..XXX..X....XX.XX....X......X...XX....XX
.X....X...X..............X..X.....X...X..X..XX..XX..XXX..X....XXX.....X..XX....X..........X..........XXXX.....X...X
.XX...........X...X....X...X..XXX...X.X...X.XX......X..X....X..XXXXX..X.XX..XX...XX.....X......X..........X.X...X..
..X..X...X......X...XX.X.....XXX....X...X......X..X....XX...XX...XXXX...XX.XXXXX....X......X...X.....XXX....XX...X.
X.XX...X...XXX......X..X..XXXX...X......XX.X...X.......XX.XX..XX.XXXX...X..X..XX..XX.......X..X....X.....X.....X...
X.XXXX.XX........X..X......X...XXXXX.XX.XX...XXX.X........XX.....XXXX.....XX..XXX..X........X...X.....XXXX...XXXX..
X...X.....X......X.......X........X..XX...X....X...XX....XXX......X....X......XXXX......XXX....XX.X.....XX...XXX..X
..X...X.........X..X........X.XX..X.XX......XX.XX.....XX.X....XXX...XX.....XX....X..XX.......X..X.X..XX..X.....X...
....XX.....XXX..X..X....X.X.X....X..XX.X..........XXXX...X....XX......X.XX.X.....XX....X.....XX...X......X..XX...X.
.X.....XXXXXXX.XX....XX...X......X..........X...X..XXX..XX...XXX.XXX....X....XX.....X..X...XX.......X.....X...X....
.X.X...........XX...X....XX..XXX......X.X.....X....X..X..X.X.....XX..X....X.........XXX..X....XX......XXX.X.X.X...X
.....XXX......XXX......X...X......XXX.X....X....XX....XX.X.X..X...X.XXXX..XXXX.XX...XXX........X.XXX...X..X.X.XXX.X
..X...XX...X..XX.....X..XX.X....X...X....X.....XXXXXX..X.X.XX...X........X...X.X....X......XXX...XX....X....X.X...X
....X....XX..XX..X....X.X..X..X...X.........XX....XX...X...X..XXXX...X...X.X...X.X..X..XXX...XX..X..X..X...X..X....
.X..........XXX....XX.....XX..XX.....XXXX...XX.......XX......XXX...X.X.XX..XX....XXXXX.......XXXXX.......X.X.....X.
.X..XX.....X....X..X...XXX.....X.X.X......X..X...X.......XX......X.X....X.....X.......XXX....XX..XXXXXXX......XX...
..X..X.XX....X..X..X....XX.XXX...X....X......X....XXXX.X.XX...XXX.....X.XXXX........X.....XX..X..XXX.....XX.X...X..
X..X...XX.X....XX..XXXX..........XX.XXX.XX...X..X....X......X.....X.......XXXX..........XXXXX....X...XXXXX..XXX.XXX
...X......XXX...X..XXX..X.X.........X.....XX.......X......XXX..X.....X.XX.....XXX..X..X........X.....X.....X....XXX
.....XXX..X...X....XXX....X.X.....XX.........XXX.XXX.......XXX.XXX.X.X..X........XX...X..XXX...........X.....XXXXXX
XXX....X....X....X...X.XX.....X......X.....X.XXX.X...XXXXX..XX...X......X....X.X....X....XXX.XX.....XX....X........
..X......XXX.........X...................X.....X....XXXX....XXXX....X..XX..X.......XXX............X.....X.X.X......
..X...X...X..X....X...XXXX.....XX.....XXX...XX....X..XXX.....X..X......XXXX...X.XX....XX....X.XX....XXX.....X..XX..
..X.....X...X.....X.X......X.X....XXX.....X..X..XXXX.XXX...X....X...XX.X....X...XXXXX....XX...X..X.....X...XXX...XX
...XXX.....XX.......XX.....X...X...........X..XXXX.....X.X....X......X.X.X.............XXXXX....XX.XX..XXX..XX.....
.X...X...X...XXX...XXX......X..X.X......XX....XX...XX....XXXX......X.X...X...XXX.....X.XX..X.X..XX.....XX...XX..XX.
.......XXX.....X.XXX..X...X....X...X..X..X..XX.....X..X....X...XXXXX...XXXXX.....XX....X...X.X..X....X..X....XX....
..X...XXXX..XX.X........X..........X..XX.......XX..X.....X...X..XXXXXX.XX...X.......X.XX.X.X...XX.XXX...XXXX....XXX
..X.X.......XX.........XXX....X....X..XXX..XX..XX......X..X..XX...X.......X.X....X..X......XX..XX.....X.X....X.....
....X.....X.XX..X......X...X......XX......XX..XX..X..XXXX.........X..XX.XXX....X...X....X...X.XX...X..X....X...X.X.
.XX....XX...X.....XXX....X.X.X.......XXXX.XX...X.....XXX...X..X....X.XX.....XX..XX...X....X.X..X.X.....X.X.XXX.....
.....X..X..X..XX....X.XXXX.X.....X.XXX....XX.X.......X...X....X....X...XX.....X..X..XX.X....XX...X..XX.X...X...XX.X
XXXX....XX...XX..X..X.........X....X.....X...X..XXXX...XXX..X..X...XXX.X.......X.....X...XXXX........X.....X.X....X
XXX..XX..X....X....XX....XX.....X.....X....XX............X...X...X.XXX...X...X.....X..X.......XXX....XXXXX...X..X..
..X..XXX....X.....XX..X......X...XX.X...XXX...X..XX...X....X....X..X....XXXX....XX....X....XXXXX..XX..X.....X......
..X...X...X.X..XX....XX.X.X....X....X..X......X.....X...X...X.....X..XX.......X...X...X..X.....X......X...X...XX...
....X...X...X..XX..XXXX...X.X.....X........X....X....X......X..X....X......XXXX.X...X.XXXXX..X....XXX.........X....
.X.....X.....X..X..XXXXX........X.......XX.X.X.....X...X.....X.....XX.X....XXXX.XX..X....X...X..X...XX...XX.....XXX
...X......XX....XX..XXXX..XX.......X....XX.X.X..XX...........XXX......X.X.......X..X..XX...X....X......X..........X
X..X....X.XX..X.....XXXXX.....XX...X.XX..X.X.XX..XX.....XX...XX.....XX....X....XX..X....X..XXXX....X.......X..XXX..
X..X.X.....X....XXX........XX...XX....XX...X.XXX...XX.X....X..X.X...XX.X....XX..X....XX.X..XXX...X......X....X.....
X..X.X.X.X...XX....X.....X...XX.....X...X..X.X......X.X.X..XX.....X......XX.XXX...XX..X...XXX..XX.....X.X.X....XXXX
...X.....X....X..X...XX..XXX.XX..XXXXXX.X..X......X...X...XXX..X....X...X........X....XX..XXX.XX..X.....X.X.X....XX
.X......XX....X..X..X...XXXX.....X....X............X.......XX.....XXX...X..X.....X..X....XXXX....XXXXX....X....X..X
.X..X....XX......XXXX.XXXX...X.....XX....XXXXXXX.X...XXX.X....XX..X...X..X.X...XXXX...X....X....X....X...X...X..X.X
.........XX....X..XXX....X.X..XXX......X...X...X..X...X..XX......X..X..X.....X....X...XXX....XX...XX...X...X.XX...X
X....X...XXXXX....XXXXXX...XX.X...X....XXX...X..X...X...X....XX....XXX....XXXXXXX.X....XX.XXXXX..X...........X.....
..XX...X.X..XXX...X...X.........XXX.X..XX...XXX......X.....X......X..X..XX..X.....X..X..X..XX..XXX.XXXX.....XX..XX.
...X..XX....X...X.X.X.X......X.........XX.X.X........X.X...X..XXXX...X...X..X...XX....X..X.....XXX.XX...X.XXXXX....
XX..X.....X.....X.....XXX....X.....X.X....X...XXXX.......X....XX...X...X....XX..X..X..XX.......XXX....X.X..XXXXX...
X...XXX......X..XX...XXXX.XX..X......X..XXX..XXXXX.XX.X.......X......XXXXXX..X.X..X..X............X........X.....X.
X........X.X....X..X...X..X...X.XXX...XXXXX...XX....X...X.....X.X.XX..XXX....X...XX.X..X....XXXX..X..........XXXX..
.......X.X..XXX.X....X...XX.......XXX..XXX..X.....X........XX.....XXX.....X.....XXX.X.....X.XX...XXXX.....X..XXX..X
..........X..XX...X............X..XXXX.....X....X.XX.....X.XXXXX...XX..XX...X.XXX.......X.X.X..........XX....X...XX
XXXXXXX.X.XX.XX..XX.X.....XXXX...XXX...XX....X..X..X.X...X..XXXXXX.XX..X....X...X....XX.....X.X......X.X...X...X...
....XXX.X.XX...XXXX.....X....X...XXX.X....X....X...X.XXX..X....XXX.XXXXX.X....X....X....XX.....XXXXX.X...X....XX.X.
......X.X......XXXX..XX....X.......X..X.....X....XXX......X..X...X.......X....XXXX.X...XXXXX.X.X.........X..X....X.
..XX..X....XX...XXXXX..XXX....X.......X.XX....X...XXX.....XXXX.................X...XXX.XX....X...XXXX....X.......X.
...X.....X....X.X......X....X.....XXX...X..XX.XXX..XX...X...XX....XXXXXXXX...X...X..XX.XX.......XXX....XX..XXXXX...
.X...XXX...X..X....X...X.XX....XXXXX..XXX...X.X....XXXX...X.XX..XXXXX......X........XX.X..........X.X..XX...XXXX..X
..XXXXXX.........X..XX.X.XXX.XXX.....XX.....X.X.....X.......XX...XX............XX...X....XXX...XX.X...X.....X......
X..X......XXXX....X..X.....X.....XX...X.......XX..X...XX.....X.X.....X....X....X....X.X......XXXX..X....XXX........
XX.....XX..XX..XX..X..X.............X....XXX..XX......X....X.........X.XX...X..X....X....XX.....XX.X.........X.....
X...XX..XX....XXXX.XX...X...X.....XXXX.....X..XX.X....X.X..XXXX........XXX..XXX...X.........XX.....X...XXX...X..XX.
X....XX...XX....XX........X...XXX..XXX.XX....XXX.X.X....X.XX....XXXXX.....XXXX..X....X..X.X....X.....X.XXX...XX....
...X.XX....X........XX........XX...XXX....XX.....X..XX.....X....XXX...X......X.XX..X.X....X.X.....XXXX.....X.XXXX..
.X...XX..X.....XXX..XXXXXX.......XXXXXXX......X...X......X.X...XXXX.XXX.XX.X.X...XXX...XXXX...X.X...X........X.....
..X...XX....XX.....X.......X...X..XXX....XX.X...X....XXX.....X......X......X...X....XXXX......X...X...X...X......X.
X.X.X..........XX..X.X.........X..X...X.....X..X..XX..X...X...........XX....XX.XXXX...XX.......XX....X..X.....XX...
..X.....X......XX..X.X.XXXX.......X...X...XXXX.X....X...X......XXXXX......X.XX......X..XX....X.XXX.....XXXX....XX..
..........XXXX....XX.......XXXXXX.......X....X...XX....XXX...X.........XX.X..XX...X.XX...........X..X.......XX.....
XX.....X...XXX..X.X...XXX......X.....XX.XXXX.XXX.....X..X....XX......X.......X..X......XXX....XX.XX........X...X...
XX...X..XX..XXX.....X.....X......XX.....XXX..X...X...XX...XX.......X...X.XX..X.XXX...X..X..X..XX.XXXXX.......X.....
X..X..X.X...XX..XX.XX...XXX...X......X..XXX.....XXXX..X....X.X.X...XX....X...X.XXX...XX...X...XX.X..XX...XX.X...XXX
X.....X...X....XX..X....XX..X....X.X.XXXXX....X.....X.X....X.X..........X..X.X.XX..X..X.....X.......XXX.....X.X..XX
X.XX........X..XX....X...X.....X...X.....X.....X......XX...X..XXX...XXXX..XX..........X.....XXXXX.X...X.X......X..X
X.......XX.....XXXX....X...X.X......X........X...X.....X.X.XX.X...X..XX..XX...X.....XXX.....XX....XXX.X......X....X
....X......X.X........XXX..X.....XX.X...X.XX.XX......X...X..X...X.XX....XX..X...X..........XXX...X..X....XX........
.......X...X..X....X......X.......X..X..X.......X....XX..XX....XX.......XX......X...XX.XX..XXXXX.X.....X.....XXXXX.
XXXX...X.XX...X.XX...X..XX..XX..X..X.X.X....X.......XX...X...X.....X....X...XX....X..X....XX...X.X...X.....X...XX..
..X....X.XX.....X..XXX..X..X....XX.X.....X....XX.X..XX...X.X...XXX....XX..X.X..X...X.XXXXX...X.X.X......XX..XX....X
....X....X......X.........X...X.......X.XX.X..XX...XX....X.X..XXX...X..X......XX.X.X.X.......X...XXXX.......X......
.X....X..X.XXXX...XX...X....X.X.X...X.X.XX.X....X..X..X....XX..XX.XXXX...X.....X.X...X..XXX..XXXXXXX.....XX....XXX.
...X..X..X..XXXXXX...X......X...X.XXX.X......X..X..X.XX.X...XX..X..X..X..X..XX.......XX.....XXX....X.X...XXX.X...X.
X.....X.....X......XX...X......XX.XXX..XXXX....X...X..X.XXX.XXX.XX....X.X...X..XX........XX...X....X....XXXX..XX...
..X.X...X.XXX.....XX..XX...X......X..X......X..X.X....X...X..XX.XX..X...X.X....XX...X.XX...X..X...X...X...X...XXX..
..X.....X..XXXXXX.XX.....X....X......XX.....X..X....X........X..XX...XXXX....X....X.X.X....X.X..X...XXX.....XX.....
...X.......X.........XX..XX.X....XXX..X.XX......X...X....XX....X...X.X....X......XX.....X......X......X........XXX.
.X...X...................XX........XX.X....X......X....X..X...XX.......XX...X.XX...XXX........X..XXXX.X.....X..XX..
.X.......XX.X.......X.XX........X...X.XX...X...X....XX....XX..X...X.XX..X..XX...XX..X....X..XXX.X..XX..X.......X..X
.X..XX...XX....X....X.XXXXX.....X.X...X..X.......X..XX..X....XX.X.X...........X...X...XXX...X...X......X...X.X...XX
.X..XX..X....X.XXX..X.XXXXX.......X.....XXX...XX....XX...XX.....X........X..X.....XX...XX.X.X.....X........X....X..
..X...X...X...........X..........XX.XX..XXX.......X.XX.X.XX.................X..X.....X......X..X........X.....X....
X...X.......X.X....XX...XXXX...X................X......X................X...XXXX........XX.....X...X......X.....XX.
...X........X....X......XXX..X...X.XXXX.........X....X....XX..X..XXXXXXX....XXXXX...XX..X..X...XX..X...X....XX.....
...X.XXXX......X...X....XXX....XXX..XXX.......X....X...XX...X....XXX.....X..XXX...X....XX....X....X..X..XX..X..X...
..X..X....XX....X....X..XX..XX......XXX..XX...XX...X..X...X...XX........XXXX....XX...XXX..X..X...XX...X..X..X.X..X.
....XX.X......X...X........X..........XX....XXXXXX..X.X.X.....X.....XX..XXXX.X.....X.....X..XX.X...XX.XX....X...XX.
.......X.X..X.XX..X...XX.......XXXXXX.XX.X......X...X.X....X..X.X....X.X.....X...X.........XXX.XX..XX..X..X........
XXXXX....X..X.X.....XX......X...X.....XX.X.XXXX.X.....XX.XXX.XX....X.......XX..X.........XX..X..X.XXXX.X..X......XX
XXX.....X...X.X....XX...XX....X...X....X.X..X.........X..XX..X...X.XX...X...X...X.....XX..X...X.....X..X.......X...
XXX.......X...XXXX....X....X........XX...XX...XX......X.....XX.....XXXX...X...X.....XXXXX...X....XX...XX...XXX.....
