12 13
.............
.............
......XX..X..
.XX..........
..X.XXX..X.X.
X.....X....X.
...XX...XX...
.....X......X
XXXX.X..X.X..
..XX.XX.X..X.
.....X.....X.
.......X.....
