18 19
...XX.......XXX....
...XX..XXXX..XX....
XX...X.XXXXX...X...
.....X....X..X...X.
.X....X...X........
.X.XX.......XX....X
.X.XXX.....X.....XX
...XXXXX...........
X..XXXX...X.....XX.
......X.X.......XX.
.XX...X..XXXXX.....
......XX...X.....XX
..XX..X..X.........
.....XX.........X..
...X..X...XXXXX...X
....X...XXXX.....XX
....X..XX....X.X.XX
..........X..X...XX
