20 22
....XXXXXX............
.XX.XXXXX....XX...XXX.
.XX.......X...X.X.XXX.
............X.X.......
XXX..XX....XX....X....
.....X.........X...XX.
.XXX...X.....XXX......
....X....X........X..X
XXX.X...XX.....XX.X..X
XXX.XXX...XX...XX....X
....X...X.....XX.....X
...XX.......X.XX.XXX..
....X..X.........X....
..X.X..XXXX..X.....XX.
X...X.....X.......XXX.
X..X..X...X.XX....X...
XX.X.....X..XX.XX...XX
.......X.X......XXXXXX
..X.......XXX.X.......
X.......X.....X..XX...
