100 101
....XXXXX.....XX...X....X..XXX....X...XX..X......XXXX.......X.......X..........X..XXXX....XXXXXX...XX
.XX...X.....X....X...XX....X....X...X.XX..X......X........X...XXXXX..........X.X..XX......X....X.X..X
....X...XX......XXXXXX...X....X.XX..X.....XXXX...X.X...XX............X.......X....X...X...X..X......X
X......XX..XXXX........X....X.......XXXXX..X...X.....XXXX..XXXX...X........XXXX...X.X...X.XX....X....
..XX.X.XX.X.............X......XX...X..XXX......XXX........X....X...X.XX........X...XX..X...X...XXXX.
.XX..X.XX......X......X...XX.XX.....X......XX.X..XXX....XX...X..XX....X.....X........X..XXX........X.
..X.XX.X.....X...XXX..XX..XX.....X..X...XX....XX.....X..X......XX....XX.X.XX.....XXX.X..X..X...X.....
X.X......XXXXX..XX...XX...X....X.X..X....X..XXXXXX.....X..XXX..XX.X.....X.X..X.X........X...XX......X
....X...XXXXXXXX......X.....XX...X....XX.....X......XXXX...X..X...X.XX..X.X.XX......X.X...X.....X....
.X....XX.......X.XX.X..XXX.......X........XX......X........X.XX.........X.........X.X....XX..XX.XXXX.
...XXX.......X......XX.....XXXX..X...X....X...X...XXXXXXX..X..XX..XX....XX...XX........XXXX.......X..
..X.......XX.XXXX.......XX.X...XXXXX.....XX.....X..........XX..X.......X...X.........X......XX.X....X
......X....X....XXX...X......X....X...X..X........X......X..XX...X.......X.....X...X...X...XX..X.X...
...XX.X....XXX....X.X...X.XXXXX.....X...XX..........XXXX.XX.....XX....X.....X....X.....X.X.X..XX.....
XXXXX...X...XX.X....X...X...XXX.XX............XX...X..........X..XXXX...X.....X.....X..X.....X..XXXXX
.......XX.X....X...XX.....X...X....XXX...XXX.....X....XXX........X......XXXX....X.....X...X..X.......
.....X......XXXX.XX...........XX...X...XX....X......X...X..XX..X...XXX...XXXXX....XX....XXX....XXXXX.
.................X.......X....XX.XX..X.....XX.......XX..X...X.....XXX..X............X..XXXX.X......X.
....X........XX....X...XXX..X....X..X..X.X....XXX......XX.X...X...XX..XXXX...........X...X..X....X...
..X.XX...X......X..X...XXXX..XX....XX.XX..X.......XXX...X....XX.XXXX.......XXX.....X...X.X...X.....XX
....X..X.X...........XXX...X....X.......X...XXXX..X...X....XXXX....X....X....XXX...X.......X.X.XX....
...X..X....XXXX..........X....XXX.XX....XX........X.X..X...X..XX.....XX...X......X...XX.XX...X.XX.XX.
...X.X..X.X...X...XXX...XXXXX..XX.XX.......XX...X.X....X.X....X.....X.......X....XX..XX..XXX...X..X..
.....X.X..X.X.X.....X.X..X.....XX.XXXX...X....X........X.XXXX...X..........XX...X......X...X.....X..X
....XX.X....X.........XX.X........XXX..X...X.......X...X....XX.....X.....XXXXX....X......X......XX.XX
.........X...X............XXXX...X....X....XXX.....X.X..X....XXX...X...X.......X.....XX.......XXXX...
..XXX.XX.X.X...X......X.X..XXX.X.X.XXXX.X........X...XX....X.....XXXXX......X...XX.X.X..XXX......XXX.
X...X......XX..X...XX...XX...X.X.X........XXXX...XX........X..X....XX...X...X.X....X...XXXX...XX.....
.....XX.XX..X.X..X.............X....XXXX...XX..XXXXXX...........X...X.......X.........XXXXXXX....XXXX
.X.X....X...X.X.........X.....XXXX..XXXXXX....X...XXX..XXXX..X....X.XXXX.......X....X.......XX.......
...XXX....X.X.....X..XX.X...XXXX...X..XXX.......X...X..........X....XX.....XXX...XX..XX...X.....XX...
..X......XX..........XX.X.X....X...X....X.XXX..X......X...XX.....X...X.XXXXXXXX...XX..X.X.....X......
X...X........X...X...XX...X..X.....X.XX.X..XXXX..X...X..X....XX....X...X.....X..X..XX...X.........X..
X.......X......X..XX.......X..XXX..X.......X....XX.....XX...XX....XXXX.......X.XXX...X......XX.X..X..
.....XX....XX...X...XX.....XX.....X....XXX....XX...XX..XX.X.XX..........X....X.XX..X...X.......X.X...
.X...XX..X......XXX....X.......XX.X.........X.X..X..X...X...XX....X...X...XX...XX............X...X...
...X.....X..X........XXX.XXX....X.....X..XX.....XXX...X..X.....X..X.......X...X...XXX...X..X...XX...X
X....XXX..X.....X..X.XXX.X......XX..X.X..X...X....XXXXXX.X...X...XX..X......X...X.....X..XXX......X.X
..X....XX....X..X..X.......XXXX.....X.X....X...XX...X......X.....XX..XXXXX........XXXXXX..XX....XX..X
.XX.......XX...XX.......X.....X.X...X.X...XX......X...XXX....XX..XX...........XX....X.....X.....XX.XX
..X...X.......XXX...X......XX...XXX.....X.......X.XX......X.....XXX.XX....XX.....X....XX....X.X......
X...X...XX.XX.XX..X....X.X.XX..XXX...X......X........XXXX.X.X.......XX..X....X.....X.X...X....X.X.XX.
XXXX....XX..X..X.....X.X.X..X...XX.X.....XX.XXXX........X...X....XXX..X..XXXXX..X....X.XXX...X....XX.
.....X......XX.....X.....XX...X....XXX......XXXXXXXXXXX....XX......X..XX.....X....X......XXX.X.X...X.
.X..XX...XX..XX.......X...XX.....XXXXX.....XXXXX....XX...XXX.....X....XX.....X.XX...X......X.....X...
.X....XX.....XX.X.......X..X.XXX....XXX.......XX....X..X.....X.X......XX....XX.X..............X....XX
.X........XX..X...XXXX..XX.X........X.......X..X...XX.......X..X.......X..X.X..X.X........X.....XX..X
.X...X........X...XX.......XXX..X..X...X....XX...X......X...X....XXXXX.X..X.X.XX......X......X...XX..
.X...X...X.XX........XX.........X..X.X....XXX.......X.....XXXXXXXXXX...X..X.X.XXX.......XX.X.....XXX.
...X.......XX...........XXX...X....X...XX.....XXX.....XX......X..X...X..XXX...X....X.......X..XXX....
..XX.XX...............XX....X...XX.....X...X..XX......X..X....X....XX...XXXXXX...X.XXX......X...X.X..
X........XXXXX.X...XX....XXXX......XX....X.XXX...X......XX.X....X.....X.XXXX...X............X.X...XXX
....X.XX....X..X.X.XXX...XXXX..X...XX.X......X.XXX..XX......XX.......XX........XX.X..XXXXX..X...XXXXX
.X....X...X.X....X.....X..XXXXXX....X...X......XXXX....XX.X...XX...X.......XX..X..X..XXX....XXX......
...X....X....XX...XXX..XX..X......X.XX..X.......XXXX......XXX....X....XX...X.....X...XX.....XXXX.....
..XX..XX...X....X...X....X....XXX...XX....XXXXX.XX...XX.............XXXX..XX.......X.X..X...X.......X
....X....XXXXX............X.X..........XX.....X........XXX...XXXXXX..XXXX....XXXX....X.XX...X.X...X.X
.XX....XXX.....XXX.X....X...X..X........X..XX.....X.....X..X.......X..XXX..X......X.XX.XXXX.....X.X.X
.....XXX...XX..X...X.XX..XXXXX...X..XXX.XX...X......X.X...XX..........X....X..X...X..X.......X....X..
..X........X...X.XXX...X..XX............X..X...X......X...........X..XX..X....X..XXX..XXXXX..X.X...X.
.....XXXX..X...X..XXX..XX....XX.X..X...XX.XXX....X...XX..XX...XX..X..XXX....XXXX......X.....X..X.X...
...X..X...XXXXX...X...XX..X..X..X..X.X........X....XXXXX....X.....X..X....XXXXXXX...X...XX..X....XX..
XXXXX...X....X..XX..XXXX.....X.....X.X...X.X..X.......XXX.......X....X..XXXXX.....X.....XX....X..XXXX
XXX....XXXXX.X.....X.......X.....X.X...X...X.X......X.....XX.XX....X....X......X..XXXX..XXXX...XX....
X...XX..X.......X....X...X.......X....X........XXXX.X.....XX..X....XXXX...XX.X.........XXXX....XX.XX.
....X...X..XX.X...XXX..X.......XX...X.X.XXX...XXXXX...X.....X.....XXX..X..XX.X..XX...X....X.......XX.
.X....XXXX.XX..X......X...X.......X.X....X..XXXXXXXX..........XX...........X....X..X.X......XXXX..X..
...X.........X.......XX.X..XX...X......X...X.........X...........XXX....XX..X...X.XX.....X....X...X.X
....XXX...X.....X.......XX....X..................XX..........X...XX.....XXX...X......XX....X....X...X
..X.XX..X...X......XX.XXX........X..XXX...X.X....XX...X....X...X....X.X..........X.X.XX...XX.X...X...
..X....XXX..X.XX.X..X.X...XXXX.X..XXX...X...X.X.....X....XX....XXX..X...XX.....X.X....X......XXX...X.
..XXX.......X..X..X.X....XXX...XX...X.XXX..XX.X.XX..XX...XX.X...XX.........X.X...XX.X....XX...X...X..
....X...XXX..X.XX....X.X...X....X...X...XX....X..X.X...X......X...XX.....X.X.X......X..X.X..X...X...X
....XXX...XX.......X.X..XX...XX.X.......XX.X..XX.....X.....X..........XX.X.X......XXX......X...X.....
X.....XX..XXXXX.........XX......X..XXXXXXX.X..X.......X........X.X.......X...XX...XXX...X....X.......
..XXX....XXX......X......X..X...XX.........XXXX.X..XX.....X.X....X...X..........XX........X.....X....
.XXXXXX....X.X...........XX...X.........XXXXX...X.XX...XX...X.X........XX...XXX....XXXXX..X.X........
.XXX.......X.....X.XX.......XXXXX.XX..X.......XXX....X...X..X..XX...X.....XXX...X.........X.....XX...
.....X........X..X.........XXXX...X...XX.....XXXX..X...X....XX.X..X...X.X.......X.XX...X.....X..XXXX.
X....X..X.......X......X...X..X.....X....XXX.....XX.....X...X....XX.....X.XX....X.X..X...X.....X..X..
X.XX..X.XXXXXX....XXXX....XX......XXXXX..........X..X.X...X...X...X..XX...XXXX..X...X........XXX....X
X.XXX...XXXX...X........X..X...X....XX..XX..X....X.XX..X..XX....X....X....XXX...XX....X......X...XX..
X.XX....XXX..X.......XX..X...X...X...X......X.XX.......X.XXXXX.......X.X..XXX.X..X...XX.XXX....XX....
..XX......X.....X....XXX..X.....X..X......X.......X......XXX...X.......X....X..X.X...XX.....X...X.XX.
.XX....X......X........XX...X.X...XX..X.....XX......X...XXXX.XXX....X..........X.....XXX..X...X......
..X.XX.X...XX.XX.X..XX.....X..XX...XXXX.XX...X...X....X....X..XXXX..XXX......XXXX...X.....X....X...XX
X.X..X...XXXX....X..X........X...X.XX...X..X.X.X...XX....X..X......XXX.....XX.....X.....X....X.XXX..X
X....XXX.......XX...X.X...X......X.....X..XX...XX........XX....XX..XX..XX........XXX.......X....X...X
XX...X...X...X..X.X.....X.....X..XXX.X.X...XXX......XX...X...X....XXX.X...X..X.X.....X........X...X..
...X.......X.XX......X..XXX...XXXX...X.....X...X.X.....X...X....X...X.X...X....XX....X....X.XXX..X...
.XXX..X......X...X......X.....XXX..XX...X......X...X.X.XX...X....X..X.....X.....X...XX......XXX....X.
...X....X...XX.X...XX...X.XX..XXX.....X....XX..X..XX......X....X...XXXXX..X...X.X....X...XXXX...X..X.
.....XX...X.XX..X.......X....XXXXX..XX...X....XX......XX...XX..XX.....X...X.X...X..X.X........XXX....
..X..XXX..X.X...X.X.....X..X...XXX...X.X....X..X.X.....X.X..X.XXX...X...X...XXXXX.......XXXX..XX....X
XX...XX...X...X.......X....XX..XXX.X.X....X..X...X...X...XX...XX..XXX..XXXXX..XXX.X.X...XX.....X.....
...X....X..XX....X.XX....X.XX.XXXX.X....X....X..X.......XX..XXXX....X.....X...XXX...X.XX...XX......X.
.XX..X..XX.....X...X...X...XX....X..X......X..X...X.XXX.XX.......XX.X...X...X......XX.XX......X.X....
.XX...XXX...XX....XX.X.X....XXXX....X..X.X.XX.....X.....XX...X...X..XX.....XXX...X..X.X....X....X.X.X
..X.X..X..X.....X..X...X.XX...XX.....X.X.X.X...X...X...XXX......XX...X.X.X.....X..X.....XX.X........X
X...XX...XX..XX....X..XX......XX.....X...X...X...X...X........X......X...X..XXXXX....XXXXX.......XXXX
