21 21
...XX...X......X....X
.X....X........X.XX.X
.....XXX...X...X.XX..
X..X.X...X...X.......
...X.X.....XX...X.XXX
.X.....XX..X..X...X..
.XX........X...XX....
....X...X....X.......
XX....X...X....XXX...
XX.X......X........X.
..........X...XXXX...
..X.........XXXXXX..X
X.X......X......XX...
....X......X....XX...
.X.XX..XX....XX..XX..
.X.XXX....XXX..X.....
...XXX..XX..X......X.
..X...........X......
..X...XXX............
..X....X.......X.....
..X..X...X.......XX..
