101 103
X.....X........X.....XX...X....X..XXX..X.....XXX..X...XXXXXXXXXX....XX.......XX.......X....XXXXX..XX...
X.XXX...XX.......XXX.X..X...X..X..XXX....X...XXX..X.X....XX....X.XX....XX....X..XX....X......XXX.....X.
X........X....X.X......XXX....XX......XXXX...XXX....X..X.XX....X.....X....X..X.......XX...X......X...X.
.......X..X.....X...X.......XXX..XXX.........XXX...XX..X..X...X..X.......XXXXXXXX.XX....X.X...XXX..X.X.
..........X..X...XX.......X.....XXX..X....X..XX..XX.....X...X.X..XXXX.X..X....X...XX..X.....X.....XX...
......X....X..XX...X.......XXXXXXX..X..XX.X..XX.......X....XX.X.......X.XX.X....X..X..X..X.......X.....
...XX..XXX..X...XX...XXXXX...XXX...X..X...XXXX.....X.....X..X...XXXXXXX..X.X.X.....XXXXX.....X...X.....
...XXX.XXXX..XX.X......XX....X...XXX.XX.XXXX...XXXXX.X......XXXX...XX..X.X......XX........X....XXX..X..
.....X.....X.XX...XXXX....X......X...XX..XXX.XXX........XXX....X.X.X...X....X...XXX.....X...X....X....X
..XX..XX...X..X.............X....X....XX...X......XXX...X...XX...X...X..X...........X...X..XXXX....XX..
....X.XX...XX.X.......XXXX....X....XX..X....XXX.X......X..X.........X...X...XX.X....X.X..X...X..XX..XX.
.XX.X.........X..X....XXX.....X.....XX....X...X.XX.......XX.......X...XXXXX..X.X.XX.X....X.....X....X..
.XX.X...X......X....XXXXX.X...X...X..XX....XX...X.......XXX..XXXX....X....XX.X.X.XX....X....X....XX...X
....X.X...XXXX....X.....X.........XX...XXX.X......X...X....X.....X...X..X.X....X...XXX....XXX....X...XX
XX....X.......XXX....XX..X.....XX.......XX...XXX....X...XX.X..XX...XXXX.X...X...XX........X..X.....X.XX
X..XXXX..XX...XX...XXXXX...X......X...X...X....X.......X...X...X......X.XX....X.....XXXX.....X..X....XX
X.X.........XX...X.............X....XXXX.......XXX...X...XXX.X.X....X......X....XXX...XX.XXX....X.XXXXX
X..........XXX........X.....XX.XXX.......X.X.....X........XX.X....X....X.X...X....XXX....X......X..X...
...X.....X........X...XXX...X..XX...X..XXX....X....XXXXXX.X..XX......X...X.....X...........X.....X...X.
.....X...X..............X.....XX..X.X.....X...X.X...X...X...X......XXXXXXX..X....XX..X....XX...X....XX.
XXX....X.X....X....X......XX...X.XX...XXX.....X...X...X....X..XXXXX....XXXX...XX.....X.XX...X..XX...XX.
XXX.XX...X..X...X......XX....X...XX..X...XX......XXX.........XXX.....X.....XX..X...X......X...X...XX...
..X.XX....X..X....X...........X...XX...X..X.......XX..XX..X...XX.X.X.....X.....XX.....X......X..XXX....
....XX..X......X..XXXX...XXXX...X......XX..X......XXX..X...XX......XXXXX.XXXXX....X.XX.....X...XX...X..
.....XX.......XXXXXXXX.X...X........X..XXX.X.X.....XXX...X....X...X......X.....X..X..X.X...X......XX...
XXXX...................XX....X..........XX.....XXX.XXX..XX..X...X..........XXX....XX...X...X......XX...
....XX.......XXXX.........X.XX.XXX......XXXXX....X......XX..X......XX...XXXX....X.X....X....XXXXX.....X
.XX.XX.X.....XX....XXXXX....XX....XX...XXXXX..X..X...XX.XX..X..XXX....X..X....X...X.......X..X..X..XX.X
..X..X...XXX.X...X.....XXX...XX...XX.X...XX..X..X..X.XX.....X........XXX....X....X......X..X....XX..X..
X..X..X..XXX...X.XX........X.....X...X....X....XX......XX........XX......XX........XX....X......X...XX.
...XX.X..X...XXX..X.X...XX.XXX.X...XXX..X..XX....XX.X..X...X.X...X..XXXX....XX..X.....XX....XX....X..X.
......X....X....X.....X......X.X....XX..XX....XX....X.X..X...X...X.XX.....X.XX.......X..X....X.X.....X.
.....X..XXXX..X.XX......X.XX.X....X..X..........XXXXX...XX.......X..X.XXX......XXXX..X....XX...X...XXX.
.XX..X.....X..X....X.XX...XX..X.X....X.X..XXXXX...XXXX.....XXXX..XX....X...X....X...X..XX.....XXXX..X..
.X..X......XXXXX.....X.....XX.X........X....X.....XXXX.X..XXX........X...X...XX.....X....X....X...X...X
...XX.........XX..X.XX.XXX......XXXXX....XX...XXXX.....X......XXX...........XXXX.........X.X..X...XX..X
X...X.......X.XXX.X..X..X....XX.....XXX...X..X........XX.XX....XX...X..XX.X......X.........XXXX..XXXXXX
..X.X...XX....X...XX..X...X...X..XX.......X....XX...X.XX.....X..XXX...XX..XX...X...X..........X........
......XX...X....XXX...XX....X........X......X..X..XXX.X....X.XX..XX....X.X...X.......X....X...X.XX.....
XX.......XXXXX......XXX..X..XX....XX.X.XXX..X....XX.....XXX..X...XX..X...X...XXXX......XX.X.....X..XX..
.....XX.....XXXX.XXXX...X..XXXXX...X...XXX..XXX...X..X....X.XX.....X..XXX........XXXX...X....XXX..X....
.XXX....XX..X..X........X........X....XXX.....XXX.XX...XX...XXXXXX........X.X....XXX..X..XXX.....XX....
...XX......XX.....XX......XXXXXXXX..X.XXX.X...XXX..X...X......XX..XXX....XX...XXXXXX...X..X.....X.....X
XX..X...XXXX..X...XXXX........XXXXXXX...X....XXXXX.......X....XX...X..XX.X.........XXX..X...XXX...X....
X...X........XX..XX.......XXX.X....XXXX....X....X...X.X......XXX.X...X.....XXXX....X....XXXX.........X.
..X....XX.....XX....XXX.....X...XX.X...X....X.....X...X..XX....X..X.....X....X....XX.........XXX...X...
.......XX.XXX.X...XX.............X.....X.XX.X..X.......X.XX.XX.XX...X.X....X.X.X..XX.............X.XX..
XX...X......X...X......X.....X......X..X.XX..X.........X....XX....XXX....X.X...X...X.XXXXX..XX..X......
..XX....XX...X......XX..XX.....XX......X.X...X..XXXXXXXX..X...X...X....XXX.XX....X.X........X...X.X....
......X..X.X...X......X.....X..X...X...X.X.XXXX..X....XXX...X.....X........XXXX......X....X...X.X...XXX
.......X.X..XX....XXX.XX....X....X...X.X.X.......X..........X..X..X....XXXXXX..XX.X....X.....XX........
...XXX......XXXX..XXX......XX...XXXX.X.........X.XX.....XX..X...XX..XX.....XX.....X.X....X.X.......X...
.X...XX.XX.......XXX....XX..X....X......XXXXX....X..X.X....X..X..X...XX....X..XX......X....XX....XX....
......X.X.......XXXX.XX...X......X..X.........X....XX....X...XXX...X..X.X..X.....X......X...X..X..X.X..
X...X...X.X.XXX....X....X.........X.......XXXX....XX...X....X.........X..XXXXXX....X........XX..X...XXX
..XX........X....X......XX.....XX.X..X....XXX..X.....X....XXX...X...XXXX....XX..XX.......X..XXX...XXXXX
...X.......X.....X......X..XXX....X......XXX..XX.X.XX..XX..X......X..XXXX......XXXX...X.....XXX........
XX.XX....X...X...X...XXX..X.....XXX...X......XXX...XX.XXXX...X...X...........X......X.X.X...XXX....X...
XX....XX.......X.X.......XX.XXX...XXXXX.X......X.........XX....X...X....XX........XXX...X...X....X....X
...X..X.....XX.X....XXXX..X..X..X..XXXX.....XX.X..XX.XX....XX....X...X......X.X...X.....XXX...XX....X..
.....X..XX.....XX.XX......XX.X...X....X..X..X..XX.X..X..X........XXXXX.X.XX...X.XXX.....XXXX..X.....XX.
..X..X.......XX...XX....X......X......X....XX.XXX...X..X..XXX......X.....XXX....X.....XXXXX..XX.XXX....
..X.....X.XX..X.X..X..X...XXX.....XXXXX.X.....XX......X..XX.....X....XX...XX......XXX.....X.....X...X..
....XXX.X..XX...X..X..XX..X.....XXXXXXX...XX.........XX.........X....X....XXX....XX....XX.X.X.......X..
...........X.......X..XX.XX......XXXX......X....XX.......XXX......XX.X.....XX..X....XX..X...X....X.....
XXXXXX.XX....XXXXX....XX.........XX......X..X...X.....XX...XXX...........X.....X...XX...X..XX..X...X...
XXX..X....X..X....X....X..........X......XX...X.X.X...XX...XX.....X...XX...X...XX.....XXXX...XX.......X
XXX...XXXX.....X..XXXX..........X.......XX....X.....X..X......XXX.....XX...XXX..X.X....XXX.X....X...X.X
XXX.X..XX..XXX...XXX..............XX....XX....XX.......X..XXX..........X......X.....XX...X....XXX......
..X..X....X......X...XXX.....X.....X.....XXXXXX..X...XXXXX......XXXXXX....XXX............XXXX.XX.....X.
.....X..X...X....X.....X..X..X...X...X.X.....XX....X..XX.....X...XX.....XXXXX..XX.........XXX....X.....
...X........XXX......X......XXXX.X.....XX.......XXXX..X...XX...X.X..X....XXXX...X.........XXXX..XX.XXXX
.X...XXX....XXXXX.XX..X..X.......X..X...X...X.........X.X..X..XX...XX.XX..XXX...X..XXXX.........XX.....
.........X......X...X....X............X.XXX.XXXXXXXXX...XX.....XX.....XXX.XX.....X...XX....XX...XXX....
X...X..X...XXXX...X....X.X.........XXXX...X.....X......XX...XX.......X..X..X.....X.X.XXX......X.XXX...X
..X....XX...XXX......X.....X...XX..X......XXXX..X.XXXX....X......X...X.....XXX...X.X.XX.....X...X......
....XX....X.XXX.........X....X..X.X..XXX.......XX...XX..XXX..XX.....XX...XX....X.X.X....X...X..X.....X.
.XX....X..X...X.....XXX...X..XX.....X....X..X..X....XX..X.....X.X.X.X..XX......X.X.XXX..X...XXXX.X...X.
..XX......XXX..XXXX.........XX..XX......XX....X..X...XX.....X.....X.X......X...X...XXX....X..X.....X...
X.....X.X.XXXX.X.....XX.....XX.....X.....X.X....X..X....XX....XX........XX.....XXXX..X.XX.XX...XX......
....X...X....X.X...X.....X.....XX......X.X.X.X....XXX..X..XX..X......X......X..........X.......X.......
.XXX.....X...X.XXX.....X...X......X........X...........X...X....XXXX...X......X.......XX.X.X...X.XXX...
.X...XXX.X.XXX...X...............X......XX....XXXX.....X.X...XXXXXXX..XX..XX....X...XX.....X..XX.....XX
.....XXX.X..X....X.XXXX.....XX.....X...........XXX.XX....XX.....XXXXX..X.....X....X..X..X.XXX.X......XX
X....X...XX...X..X..X...X...............XXX....X......X.....XXX.XX..XX...XX....X.....XX.X.X.....XXXX...
X....X....XX.....XX...X....XX....XX.X...X...XXXX..X......X....X.X...X.......X....X....X.X...XX...XXXX..
X.....XXX.....XX.........X...XX..X..X..XX....XXXX..XXX.X...X....X.X...X...XXXXXXXXXXX...XX.....X......X
X...X.X.....X.....XXXX...XX....XXX...X.......XXXXX...X.......X.......X..X.........XX....XX...X....XX...
..X.....XXXXX..X..XXX....X..X...X..X....XXX...XX........X.X........X.X.....XXX.......X.....XXX..X.X..X.
...X...X..XXXXXX.XXXX.XXX..X..X.X.....X.....X.X.....X...X...X.X..X.....X.X...X...X.....X....XX..X...XX.
.X...X....X......X....X...X..XX...X......X....X.X...X.XXXXXXX....X.XX....X.X.XX.......X..XX.X...X..XX..
..X.....X......XXX.XXXX.XXX...X......X.X...X....X...X.XXXX..XX...X....X....X....X.XXX.X..XX...X.X..X..X
X.X.X.X.XX...X.....X....X...X......X...X....XX..X.XX....XX....XX..XX....X...XX..X.....X......XX.XXX..XX
..X.X........X..X.......X.X....X......XX..X..X..X....X...X.XX..XX.X..X..X.X..X..X....XX...XX..X..XX.XXX
.......X.....XX...X.X.....X...........XX..XX........X..X.X..XX....X.X..X..XX......XX.X..X...X.XX.......
XX...XXX.XXX....XXX....X........X.....XX..XX..XXX.....XX....X.......X....X....XXXX.....XX.X..........X.
XX...X...X..XX....XX...X.X.XX...X.X....X......XXX.XX.XX............XX......XX...X.....X...XX...XXXXX...
XX...X..XX..X..XX.XX...X.X.X..X.X...XX......XX.......XX........X.......XX.....X...X.....XXXX...XXX...XX
...XXXX.......XXX....X...X.X.XX.........XX...X...X.......X...XX...XX...X....X................X...X.....
.XX....X.....XX....X.....X.X.X.......XX....X..X........XXX.X.X..X.X..XX..X.....X...XXXXX....XX.X....XX.
....XX...X......XX.......X...X..........X..XX...X..........X...XX...XXX....X.....X.......XX....XXXX....
