9 11
...........
...........
..XXXXXX...
X..........
...X..X....
.X....X....
......X....
......X....
......XXX..
