113 113
XXX........XXX....X.........XXX.........X...X.......X...X.......XX.......X.................X...XXX...XX..XXXXX...
XXX......X.....XX.......XXX.....X...XXX...X.......X...X.X.....X......XXX...X...XXX.....XXX...X.X.....XX..XX....X.
XXXX........X..X...X....XX...X..X.X.....XX...X....XX..X..X......X.XX.....XX..X...X........X..X....X..X...X..X....
.....XX...X......X.....XXX.X.X....X..X..XX......XXXX...X...X......XXXX...XX...XX.X......X..XX...X....X.X...X....X
.XX.....X....X......XX...X.....X...XXX.X......X...X..X...XX..X.......X........XX...X....XX....X.XXXX.X...XX..XX..
.X..X......X....X...X.......XX...X..XX...XXXX.......XXXX.XX.....XXXX....X.....XXX.......XXXX....XXX..X......XX...
.X....XX......X...X...X......X.XX...XXX..XX...XX.XX.........XX..X.....X.....X..XX.X...XXX....X..XXX.XX..X...XX.X.
...X..XXXXX...XX.........XXX......X......X....XX......X.X....X.XX.XX........XX..X.XXX.......XX..XXX.XXX...X......
.....XXXXX....XX.X.X...X.....XX........X...X.......X....X.XX......XX.X......XXX...XX..XX.......X..X.......XXX...X
..XX.....X.....X.X...X....X........XX..XX..XXX.XX....X........X......X...X..XX....XX..X....X...X....XXXX..X.....X
..XXX........X.....XX...X...X.XXX.....XX...XX..XX..XXX...X........XXX..X.X.....XX..X....XXXX.XX..XX....XXX..XXX..
......X...XX..X.......XXX.....X......XXX...XX.XXXX.XX..X.XX..X.X..XX..XX...X...XXX...X...XXX....XXXX...XXX.......
.X..XXX....XX.X.....X......X.......X.XX.....X.........X..XX..X...XXX...X.....X..XX..XX.X.X.........X..XXXXXXXX...
.X....XXXX.....XX.....XXXX...X...XXX....XXX.......XXX...XXX..XX........X.XX...X...X....X...........XX....XXXX....
...XX...X....X...XXX.....XX..X...XXX..XXXXX...........XXXXX.....X........X..X...X...X.........X....XX..X....X.XXX
XXXXXXX...XXXXX......X...X.......X....X.......XX.....XX..XX...X...XXXXX....XX.....XXXXX.....X...XX.XXXXX......X..
...........XXXX.X........X.XX......XX............XXX.XX.....XXXX.....X..XXXXX..XX....X......X..X...XX......X.....
....XX..XX.XXXX.......X....XX.XXX..X...X.......X.....X..XX...XXX.X.X...X..XXXX...XXX.X.......X.X.X..X..XX...XX...
..X....X...XXXXXX..X......X...X....X.....X..........XX.X...X...X.X........X....X.X...XX....X...X....XX.X..X....X.
..XXXX...XX..X.....X.X........X.XX..............X....X...XX....X.XX....XX.X...XX....XX..XX.XXXX...X......XX..X...
X...XXXXXX...X...X...X.....X..X..XXXX.....X..XXX...X.....X..XXXX....XX....X.....X.X....X...XXX..X.....X...XXXXX..
..X.....X..X.....XX..X...........X....X...XX.....X.......X.....X..XX....X....X..X..X...........X........X...XXX..
.X....X...XX..X....XXX....X....X...X....X..X........X...X...XX..XXX...X....X...X...X.XX...X....X.X...X..XXX...X..
...X....XXXX....X..XXX.X....XX.....X.......XX.....X...X.X.X.....X...X....X.X...X......X...X.XX.....X.XXXX.....X..
..XX.X...X...XX...XXX..X.X.....XX..X.....XX...X......XX...XXXX......XX.X.X..........X...X...XXX.X..X.XXX..X......
XX.....X...X.......X..XX...X.......X...X....XXX....X..XX..X....X....XX...XX.....XXXXXXX.XX..XXX....X.....X..XX...
....X...X......X.X...XXXXX...XX........X.X..X...X.....X...X.X..XXX....XXXXXXX...XXXX........XX.....XX....X.X.....
.XX...X...X.XX.X..XXX........XXXXXX.XXXX..XX..X.....X...X...X..XX..XX.........X..X.....X....X..X......XX.....XXXX
.XXX..X..XX....XX.......XXX..XXX..X...XXX.X..X...XX..XXXXX..X..X..XXXX.....XX..X....X.....XXX....XXX..XXX...X....
.XXX..X.......XXX....X......XXXX....X.X.....X..X...X.......X...X.........X...X......X.X.X..X.......X.....XX......
......X...X...XXX......XXXX...XX.XX.X....X....XXXX....XXX..X...XX.....X....X....XXX.....XX...XXXXX...X.......X...
X...X...X...XXXXX..XX.XXX........XX....X...X..XXX...X...X.X...XXX.XXX.X.....X.....X..X.XXX..X..XXXXX.X..X......X.
..X..XX......XXXX.....X........X................X.....X.....X.XXX.XXX.X...X....XX..X.X..XX..X......X.X..XXXXX....
.XXX.......X...X..XXX....X............X...XXXXX....X.....X........X.....X....X..XX.X.XX.XX......XX...X....XX....X
.XXXXXXX...XX....X.....X.X....X...X...XXX...X....X...X.......X....X........X..X....X.XX..X..XX....X....X.....XX..
........XX..X.X.XX..XX.X...X....X....XXX....X....XX.....XXXX...XX........X....X..X...X...XX.X..XX..XX....X.X.....
XXX...X.....X...XXX..X.......XXX...X.XXX..........X..XX........X...X.XXX....XXXX.....X....X...X..X.XX...X..X...X.
....X..X.....XXXXXXX....X...XXXX.X...XX....X......XX......X......X.X...X.XX..X....X.......X......X..X.X.X...XX.X.
...XXX.X.....XXX....X...X....X......XXX.XX.....X...X..XXX.XXX.XXX..XXX.....X....X.XXX............XX...X...X....X.
.....X.XXX...XXX.XX.X..X...X....X.X.XX..XX..X....X.XXX......X.....XXX..XX.....X...XXXXXXXX.XX..........X......X..
..X....X...X.X...XX..X.X.X....X...X..X....XXX.X..X.X....XX.......X..X...X...X...XX..XX...X..X..........X.X.XX...X
....X....XX..X.....X.....X.........X....X..XX.X..X.X..X....XX.........X...XXXX..XX...X.X....XX...X.....X...X.....
...XXX..XXX.....X.....X....XXX...X....X..X.......X....XX......X.X........XXX...XX..X...XX....X.X.X..XX.XX....XXX.
.....X.......XX...X.X.....XXXX.X....X..X....XX...XXXX.........X.....XX.X...X......XX..X...XX...X.XX....X..X..XXX.
..XX...XX....X......X..XX...XX.X..X....X.......XXX..XXX.X...........XX...X....X.......X..X....XX.X...X...X..XXXX.
XX....XX..X....XXX.............XX...XX.....X.X.......XX....X...XX.......X..XX.....X...XX.X.XX..X.X.X.....X.......
....XX...X..X......X.....X......X.XX..XXX....XXXX..X.....X.XXX.......XX.X....X.XX.X...XX...XXX.X.....XX....X...XX
.XX.X....X........XXXX.X.....XX....X......X..X.....X..X....XX..X.....XX...XX...X....X..XX.........X.....XX...X...
.XX...X....X...........X.........X...XXXX....X.XXX..X...X..XX..XXX....X..........X.....XX...X...X...XXX........X.
.....XXXX......X...XX..X....X.......XXX...XX...XXXX.......XXX.......X...XXX...X........XXX......XXXXX...X...X....
..X..XX.....XX...X.....X..X.....X.XXXX....X...X..X.....X....X.X...X.....X...X.X...X........X.......X......X...X.X
X...XXX......XX..X...X.......X....X....X..X...X....X.....X....X.X.X..XX.X......XX........XXXXXXXXX...X.X..XX....X
....XX.......XX.X..X.....X.....X.......X..X..XX...XX.XX....XXXX.X....XX......X.X...XXXX..X..XXXXX....X...XXXXX...
.X..XX.XXXX.....X.....XX....X......X...X..X.....XX......X.......XX...X...X.......X....X.XX......X................
...XXX.XX......XXXX.XXX...X.X...X......XXXX.XX........X...X..XXXXXXX...X...XX.......X......X........X.XXX....XXXX
.....X.....X.X.XXX..XXX.X.....X.....X..XX...XX....X...X..XX.........XXX....X......X....X.XXX.XXX.X....XXX.XX..XXX
..X......X...X...X.........XXXX..X..XXXXX.....X.....X..X....XXXXX....X..X..X.XXXXXXX.....X.......X.X...XX.....X..
..X.X.......XXXX...X...X.........X.XXXX...XXX..........XXX..X......X...X..XX.....X...XX.....X......XXX.....XX....
......XXX.X..........X.........X...XXXX.X.X..........XX.....X....X..X....XX....X.X..XX..XXX.......XXX....X.......
.X......X.......X...XXXX.....X.......X..X...X......X....XXX..XX.....X....X..XX...XX..X.......XX.......X....XXX...
.X...X..XXXX.XX...XXX......X....X......XX.......XX.....XX..X....X....X.....XXXX...XX...X...X.......X....X........
...X...XXXX..XXXXXXX..X.......X.....X.XXX....XX.XXX.XX..X.......XXXX.X......X...X.XXXX...X...X...X...X....XXXXXXX
.......X....XX.......X..X.X......XX.X..X......X...X..XX.X.........XX........X...X......XXXX......X.....X...X..X..
....X....X...........X..X....X....X..X....XXX........XX.......XX...XX...X.........XXX.......X...........XX....X..
X.....X.....X.X......X.....X....X.XX....X...XXXX......XX......X..X.XXXX...XX...X..XXX.XXX.........X...X.......X..
..XX.X..X.X.X.....X....XXX....X.X..X.........XXX....X........XX.XX..XX....X....X.XXXX.....XX.XXX..XXX..X......X..
.X...X.X..X....XX.X.XX..........XX.....X...X...X.XX.......X..X..XXX....X..X.X......X...X.....XX..XX..X...XXXX....
...XX..X.....XX...X.XX....X....XX...X..X.X.......X...XXXX...XX....XXXX...X..X.X....X.X...X......XXX.......XX..XX.
XXXX..X...XX.X....X.....X...X...X.....XX......X....X...XX.XXXX..X...XX..XX......X....XX....XXX........X...XX..X..
.....XX.X....X.X......XXXXX.X.X......XX...X.X...XXXXXX.......X...XX...X.X..X......X.....X..XX..XX........XXX....X
.X..XX..XX...X...X.XX....XX...XX.....X..X.X.X.XX.........X.....X......X.X..XXX......XX..X..XX.....X....X.X...XX..
.X...X.....X.......X..XX.XXX..XX..X....XX...X.XX......X.....X.....X...X.X......XXX..XX..X.....XX....XX.....XXX...
...X.X...XXXXXX......XXX.X....XXX..XX.........XX....X.X...X.....X...X.....X......X.....X..X...XX...X......X....X.
X....X.X....X....XX....X...XX.XXXX.X.......X.....XX.X..X..XX...X.......X....X......X.....X....XXXX...XX.....X..X.
..XXXX.XX...X.X.....X......X..X..X...XXXX....X......XX....XX.X...X...XXX..XXX...X....XX....X..XX....XX......X..X.
.XX..X.X......X.X.XXX.X.XX.X.....X..X.....X....XXX........XX..X....X..XXX.....X...X..X.....XXXXX.XX....XXXX...X..
.XX....X.X...X....XX....XX.....X..XXX..X......X..X...XXXX...X.X.....X....X......XX..XX.XXX.......XX..XX....X..X.X
....XX.....XXX.X.....X.X....XX.XX..XXX...X....X......X....X.......X....X.....X...X...X..XXX......XXX..X....X.XX..
..XXX.....X.........XX.........X...X.....X...XX...XX...X..XX...X..X..X..X......X...X....XXX.XX...X....XX...X.X...
..X...X...X..XX.X.....X....X..XX......X....X..X.X......X....XX....XX..X.....XX....X......XX...XX....X....X...X.XX
XXX.....X.XX.X..X.XX....X..X...XXXX.X.X.....X...X.X......X..XXXXX.....X..X......X........XXXX...X.X...X......X..X
.....X..X......XX..X.XX.XXX..X....X...XX..X..X....XXX...XX.XXXXX...XX..XXX....X....XX....X........XX..XXX....XX..
.XXX...X..X...X..X.X..X..XX.....X....XXX.....X.X..XX..X.......XX.X..XX.XXXX...XXXX.....X.X..XX.....X.XXX...XXXXX.
.XXXX..X.........X....XX......X....X.....XX..X....XX......X......XX.XX..X.....XXX....X.X..X...XXXX....X..X....X..
...X...X...X.....X..X.....X......X....XXXX...XX...XX...X.....X...X....X...XX....X......XX.XX....X...X.X.....X...X
X....X...XXXX..XXXX.....X...XX.X....XX.....X......XX.....XXX...X.X.X.....XXX......XXX..XX....X..X.....XXX....X...
..X...XXX......X....XX....XX...XXX.....XX..XXXXX..XXXX..XX..X....X...X.....XXX.X..X...X......X.....X..XX.....X.X.
.XXXX...X....X.X...X...X..X..XX.......XXXXXXXXX..XX..X...X....X...X.........X..X.XX.X...XX.....X.......X.XXX...X.
......X..X.....XXX.X.XXX.XX...X..XX.X.......XXX..XX....X...X......X.X.....X...XX....XXX....XX.....X.X....X.....X.
..XX.....X.XX.XXXX...XXX......XX.XX....X....XXX...X.....XX...X.......XX...X..XX......XX..XXXXXX.X...X.X.....X..X.
XXX..X.....XX.XXXXX...XXX..XX......X.XXX...XXX..X...XXX........XXX.X....X.....X.XXXX.XXX......X.X..XX.....X...X..
XXX.X.....XXX.X.....X.X....XX...X....XXXX..XX..XX.........X.X....X....X.XXXXX....XXX...X..X.....X..XX..XXX......X
X.....XXX.....X....XX......XXXX...XXXXXX..XXX......X........X.X...X...X.XXXX...X....XX.XX...XX.....XXX.....X.....
..XX.....X....XXXX.X...X...XXXXXXX.......XXX.....X.......X.XX...X.XXX......X....XX..X..X.......X....XX.XXXX..XXX.
.X....XX....X......X...XXX.X...XXX...XX......XX.....X....X..XXX...X....XXX.XXXX....X..XX.X.X......X..............
...X......X....XXXXX..XX...X.X.XXX......X.......X...X..XX...X....XX.XX..X..XXXXXX..X.....X...XX.X.....X.......XXX
X..X.X.......X.....X...X.......X....X.....XXXX....X..X....X....X.XX...X...XXXXXX..X.........X...XXXX......X....XX
...X....XX...X..XX...X.XXXX...X........X...XXX.X.....XX...X.XX...X..X..X..XXX..X....XXXX....X......X.X.XX.XXXX..X
.X..X...XX......XX..XX.XXXX...X.X....X...X...X...X....X.X.X..XX..X..........X....XXX...X...XXXXXXX...X....XXX...X
.XX.....X.....XXXXX....XXXXXX.....XXXXXX.....XX..XXXX.X.X..X....X..XXXX.....X...XX...X...X.XXX..X.....XXXXXXX....
..XXXX..X.....X..XX.X..X..X....X..XX.....XX.....XXX...X..X.XXX..X....XX..X..X......X..X..X...X....X...XX..X...XX.
X....XXXX...X....XX.X..X....X.....XX..X..X..X.......XXXX.X..X..XXXXX......XXX.XX......X.XXXX.X...XX.XXXX....X.X..
...X.XX...X.XX...XX...XX........X...X.XXX..X..XX.XXX.....XX...XXXXX.....X...X..X..X...X........XXXX.X....XX.....X
.X......XXX....X..X......XXXXX....X.....X.XX.XX..XXX....XXXX......X.XXX..XX.XX....X...X.............X........X...
..X.X........X.XX......X.......X..X..X....XX....XXXXX...X......XX...XX...XX.......XXX...X....XXX...X.....X.X.....
X.X.......XX.X....XX.X...........XX....X..........X...XXX......XX..XXX.......XXXX...XX....X......X.X.X.....X..XXX
.....XXXX....XX......X..X.....XXXXX.......X..XXXX......XXX..XX..X...X......XXXXXXXX.XXXX.XX...X......X..X.....X..
.X.........X.......X..X...X...X...X.....X.XXXXX......X...X....X.X...X........XX...X......XXXX...X.....X.....X....
....X....X.....X......XX.....XX.....XXX......X..X..........X..X.......X...XX....X.....XXXXXX....XXXXX.XX.......X.
......X..XX......XXXX....X.X..X..X...XX..XX..X....X..XX.XXXX.X......X...X.X..X..XX..X.....XX......XXX..X.XXX.X...
...X....XX....XX.XX...X..X.XX.X...XX.....X..XX...XX...X..XXX...XX.....XX..X..X.....XX..XX....XXX...XXX.....X....X
.....X...X........X.X.X..X..X...X........X.X...X..X.X.XX...X.......X...X.....X.XXX.XX...X..X..XX.X..X...X....XX..
..XX...X........X...X.......X..XX..XXXXXXX...XXXX...X......X.....X...X.......X.....XX...X..XX....XX...X...XX.....
