97 99
..............XXX...........XXXX..XX....XXXX........X...X..XXXX....X..XX....X.....X...X..X........X
..............XXX......XXXX.X.....X..XX.........XXX...X....XX......X..XX....X...X...X....X.X....X..
X.....XX......XXXXXXX..XX...X..XX...XX........X......X..XX.....X...X..XXX...XX...........X.X.XX....
..X...X..X..X.........XXX....X.XXX..XX.XXXXXXXXXXXXX.X.......X...X....X...X....X.X...XX..X...X...XX
.XX.....XX........XX.......X........X..XX............X...XXX.XX..XXXX.X.XXXXX..X...X.....X.....X...
.....X..XX...X.........XX..XX.X...X...X....XX......XX..X..XX..X..XX...X...XXX..XX.....XX......XXXX.
XX...X.....X...X...XXXX...XXX.X.X........X....XXX..XX.....XXX.....X....XX.....X...XX....XXX.X...XX.
X......XXX.......X..XXX.XX....X.XX.......XXX......X...X........XX...XX.XXXX.....XX...X......X......
X.X...X....XX.......X...X..X....X..XX............XX.X...X....X..X......X..X..X.XX......X....X....XX
..X...X...XX..X.......XXX....X..X...X............XX.X.....XX.XX....XX.....XX.X....X...XX....X.....X
.XXXX..XX.XX...X...X....XXXXXXXXXXX..XXX........XX..X..XXX.....X.X......X....XXX....XXXXX...X.....X
..XX...X..X..X.X.X...X...........X...X...XX...X.XX...............X........XXXXXXXX....X...X....X...
X..X.....XX......X.....XX.....XX.X........X.XXX.X......XX.....X...X....XX......X....X....X..XX.....
XX..........X.......XXXXX..XX.......X...X.X.......XXXX.XXXX.....X....XXXXX.......XX.XX.X.X......X..
XX..XX....X.X.....XXX..XXX.XXX..X.X...X...X....X.....X..XX..XX.....X.XXX...XX...XX.....X.X.XX......
XXXX......X.X.X........X.....X....XX....XXX....X...X..X.XX.......X...X.....XX.XX...X.....X..X..X...
.....XX.......X.....XX....XX...X...X.X..XXX...XX.X.XX....X...XXX....X..XX.....X....XXXX.....XX...X.
....XXXXXX.X...XX...XXX...X......X...X......X....X.X...X...XXXX...X...XXX...X...X..X..X...X..XXX.X.
..X.....XX...X.....X......X.X...XXX....XXXXXXXXXX....XXX..XXX...X......XXXX.......XX....X....X.....
..XXXX..X......X.X...XXXXXX.X.X....XX.............X...XXXX........XX.X......XX.............X....X..
XXX....X..X......XX..XXXXXX...XX...X..XXX.....XX......X..X...X.X.....X..X........X.....X...XXXX....
....X....X..X........XXX.........XXX...X..XXX...XX.......XX....X.X....XX.....XX..X.X......XXXX...X.
....XXX....X....X..X...X..XXXXX...X..X...XXXXX..X......X....X....XXXX....X.....XXX.X....X...XX.X...
X...XXX...X..XX.X....X..X.XX....X...XX..XXX....XX.XXXX...........X.......XXXXX.XX....XX......X.X..X
....XX..X.X.X...X.....X......X...XXXXXX.....X.X...XXXXXXXXX..X...X.XXX...XXXXX....X........X.X.X..X
.X..XX......X..XX...X....X.....X...XX......XX.X.....X..XXXX..X...X.X....X......X..XXXX.....X.X..X..
...XX..X.....X....XXXXXX.....XXXXX.....XXX.......XX....XXXXXX....X....X............XXX.....X....X..
...XX...XXXX.XXX..........X....XX..X.......XXX.X...XXX..XX....X.....X..X....X...XX.......X.........
...X..X....X..XX.......XX.X.X...X.......XX.XXX.X.....XX.X..X..XXX.X.XX....X..XX.....XXX.........XX.
.....XX..X....XXXX.....XX.....X.X...XXX........X..XX....X.XXXXXXX.X.....X.XX....X.......X...X...XX.
..X...XXXXX..X.....XX....X.X....X....XX...X...........X...XX..XXX.XX....X.....X...XXXX....X....XXX.
..X.X........X..XXXXXXX..X...X..X....X..X.X...X..XX.............X..X.X......XXX..............X.....
........XXXX..X.............XX....XX..XXX...X...XX.......X...X..XX.....X.XX................X....XXX
.X...XX...XXX.XX...XXX....X....X...X..XXXXXXXXX....XXXXX...X...XX...XX.X..X....XXXXXXXXX...........
...XXXXX....X..X.X.X....XXX......X....XXXXXX........X....XXXX.....X.......X..X.XX........XX........
X........X...X.....X.XX.XXX...X..XXXX..........XXXX...X..XXX..XX......X.XXX....XX.X.........X.XXXXX
X.......X..X...XX....XX.XXXX..X.........XXX....XXXXXXX....X..X.....X..X..XX...XXX.X.....X.X...X....
X..X....X...XX.XXXX..XX.X....X..XX........X....X...X...XX.X..............XX.....X..XX.....XXX...XX.
XX....XXXXX..X..X...X...X.X..X.........X....X....X.X.X....XXX.....X....XXXX..X.....XX....X.........
....X.XX.....XX...X...X.........X.X......XX...XXX....X.X....X...XXX..XXX.....X.X.X.........X...X...
.XX.X....X....XXXXXX..X..X.X......X.XXX...X..XX...X......X....X......X.....X.....X...X..X..XXX...X.
.XX....X...XX.X.......XX.X.....X....XX....X..X........XX.X.XX.XXXXXX....X..XX...XXX....X....XXX....
.....XXX...X..X..X..X..........XX..XXX.XXXXXXX.X...XX....X..X.XXXX..X.X.X...X.XX....X....XX...X...X
X....X.....X...X.X......X......XX....X...........X......X...X..XXX....X.X.X...X..X....XX........X..
..XX...XX....X...X...XX.....X.....XX.XX.......X..XXX.X..X.XXXX.XXX.X......XX....XX.......X.........
.XXXX..XX.......XX.X........X........X..XXXXX.X....X...X..X......X...X.....X.X........X...XX...XXXX
.......XX...X......X...X...XX.....X....XX.......XX.XX..X......X...X.....XX.X.XXX.XXX....X..X....XXX
X.........X......XXX.....X....XX....XX.......X...X.XX......X....X...X.X..X.......XX..X...X....X..XX
X...X...XXX.XX...XXX..XX....XX...X.....X.X.....X......XX.....XX..X..X..X....X....XX.X..X....X....XX
XXX...X.....X..X.......X..X.....XXXXXXXX....X.....XXXXX.......X....X...X..X...XX....X.....X.......X
...........XX.....XXXX.XX.....X....XXX....X.X...XXXX....X..XX.....XX.........XXXX..X..XXX.XX....X.X
.X...XXXX..X..X...X....XX........X...X........X......X..X..XXXXX...XXXX....X....X....XX......XX.X.X
...X......X..XX..XX.X...X...XX...X.........XXXX...X....XXXXXXXX..X...XX.X.....X.X........X........X
X..X...X....X..X..X...X..X..X..X......X.....XXXXX...X.......XX..XX......X...X......XXXXX...XXX.....
X.XX.X...X.....XX.XX.....X.XX.....X.......X..XX.......X..XX.XX...X..X...XXX....X...XXX..........XX.
..X..XX......X..X.X....X......X.X..XXX.X..XX.XX....XX....X.......XX...X....X.....XXXXX.............
.X..XXX.X.XX.XX.X...X.........X..X...X...X...X...X....XX...X......X.XXXXXX.X.XX......X..X..XXX...XX
...X..X.X.XX..X.XX....XXX....X...X.......X.....X.....XX..XX....XX.X.XXX....X....X....X..X......X..X
..........XXX...X..X..X........X....X.............X...X...X....X..X...X.....XXX.X...XX....X....XX..
..X....X...XX..XX.X...X.XX..X.....X...X...XXXXX.....X...X.X...XX...XX.....X.X.....X....X......XX...
X.XXX....X...XX...X...X...XXX...X...XX..X..XX....X..........X......XX.....X....XX........X.XX....XX
X...X........X.......X....XXX....X..XX...X.....X....XXXX...XX..X........XX...X.X....XXXXX..XXX.....
....X...X......X.....X......X..X...XXX.X.....X....X...X..X...XXX...X.......X.X...X..XXX...XXX..XXX.
.X....XXX......X....XXXX..X....X....X..XX.......X.......XX.X.........X...XXX....XX..XXX.XXXX..XXXX.
.X...X..XXX....X......XX....XX....X...X...X.....XX...X.........XX.XX.X....XXXXX....XXXX......XX..X.
...X....X...X..XXX.....X.XX.....XXX..X..XX.....X...X...XX.XXXX.XX......XX..X...X...XXX........X....
............X..XXX...X...XX..XXXXXXXXX.XXX.......XXX.XXXX..XXX..X...X...XX...X....XXXX.X...X..X...X
....X....X....XXXX.........X...X....XX.X....X.....XX....XX....X...X...X...X.....X....X...X.X.XX.X..
X.....X....X..XX..XXX....X...X...XX......XX....XX..XX.......X.X..XX....XX.....XXXXXX.XX..X...XX....
........X..X..XX..X...XX....XXX...X...X...X..X..XX....XX.XX...X...X....XXX........XX.XX.....XX.....
.X.....XX.XX...X....XXXX..X.....X.X.X...X....XX...XX..XX..X..XX...X.....XX.XXX..X....XX...X..X.XXXX
...X.X....XX.X.X...XXXXXX...........XXX.XX.X......XX....X.X...X.....XXX.XX...X.....XX...XXXX...X...
X..X....XXXX.....XXX........XXXX...X..X.XX.....X...X......X.X.X.XX..XX..XXX..X...X..X......X..XX...
X.X...X....X..X...XX.....X..XXX..XXX....X...XX.X.X.XXX......X..........X....XX...XX....XXX.X....X..
....X....X.X......XXX......XXX..X..X...XX....X...X.XX..........X.XXX...X...XXX.X...X.......X..X....
.X.....XXX...X...X......X....X.....X...X...X....XX..X.XXXXX..X.X..XX.X..X......X.X...XX.....X.XX...
...X...X.......X...X......XX...XXX.......X....X...X...X......X.XX.......X.X......X..XX....X......X.
X......X......XXX..X.....X........XXX...........X..X.......X...X..X...XXX.X...XXXX.....X.....XX....
X.X.........X.....XX........X.X...XXXXXXX....X.....X.X.....X..XX..X...X.....X....X...X...X....X.X.X
..XXXXXXX.XXXXX...XX......X.X...XXXXXXXX..XX.....X...XXX..XX...X....X......XXXX..X..........X.....X
.XXXXXX...X.......X..X.......X......X....XXX........X..X.....X...XX...XX...X....XXXXX.....X....X...
....XXX.XXX....X..X......X.X...X....X.XX.....XXXX.X.X..X...XXX..XXX......X...X..XXXX..X...XXX......
X.....X..XX..X...XXXX.X..X..XX...XXX..X..XX....X..X.X....XXXXX..X....XX.....XXXXXXXX....X.....X.XXX
..XX.....XX..X...X....X.X...XX..XXX..XX.XXX......X....XX..XXXXXX........X.X......XX..XX......X..XXX
.XXX...XXXXXXX...X........X...X...X...X.......X....X.XX...X...XX.X.....XX..X.....XX.X......X...X...
.....XXXXX.........XXX...X..X.X....XX....XXXXX....X..XX.X...X......XXX...X......XXX....X...X.......
..............X........X...X..X..X...X...XXXXX.X..X............XX...........XXX..X...X...X...XX.X..
..XXX.....X.X.X...XXX......X.............XXX...X.....X...X...X....X...X...X..XXX...X..........X....
X.....X.....X...X.....X......X....X...XX.........XXX...X...X....X...X.X......X............X...XX...
...X...........X..XX..X..XX....X..X......XX...X...XX......X...X..XX.......XX........X...X........X.
.X.....X..XX.X...X...XX..XX.XX.X......X.......X.X.......X...XX...X.....XX.......X.....X...XX...X...
....XX...XXX.......X..X.....X....X......X.....X...X...XXX......X...X...XXX.........X.........X.XXXX
.....XXX..XXXXX.X...X.X...X...X....X........X.....X.....X..XX.....X..X...........X...XXX...X.X..X..
.XXX...XX...XX..X.X.....X.....X...XXXX...X.....X......X..X....X.X...XX......X....XX......X.X....X..
...XXX.XX....X.....XXX.....X....X..XX..XXX.X.X...XX......X..X...X.....X........XXXXXX....X.........
.....X.....X.....X....XX.X..XX...X..X...XX...X.......X......X.......X...X....X....XXX...X......X...
..XX.....XXX..XXXX..X....XX......XX.....XX..XX.....X......XXX....XX.......XXXX..X.....X...XXXX.....
