19 20
....X.....XXXXXXXXXX
.XX...X.............
...........X........
..XX...X...X.....X..
.....X.XXX.X..XX.XXX
.........X..........
...XX.XX.XX.....X...
.X..X.......XX......
..X.....X......XXX..
X.X..X..X.XXX......X
X.X..X..X.....X..X.X
X.X......X...X...X.X
X..........X...X....
...X..XXX..XX.....X.
.X......X.......X...
.X......X.......X..X
............XXX..X..
XXX..............XX.
XXXXX...............
