87 87
XX.....X......XX...X...XXXX.....XXX....X..XXXXXXX.....X...........XX...XX..XXXX..XXXX..
XX.....X.XXXX..X.X...X........X.....XX....X....XX.....X...XX..XXX....X.....XX....XX....
XXX....X....XX...XX....XXX.XX...........X...XX.XXX....X....X...XXXXXXXXXXX....XX.......
XXX.XX.XX........X..X...XX.....X...XX.....XXXX.X....X....X.X.X................XX...X...
....XX.....X..X..X....X......X...X...........X....X....XXX...XX.........XXXXX....X.XXX.
...XX...XX....X.XX.XX....XX..............X.....XX..X...X......X.......X..XXXXXX........
XX....X.....X......X...XXXX...X...XXX..XX...XX.XXX...X........X..XX......XXX....X.X..XX
....XXXX....XX...X...X..XXXXX...X......X..X..X...XX.......XXXXXXX....X....X..X..X....XX
.XX..X...XXXXX.......XX.XXXXXX..X...XX.X.X...XXX......XXXXXXXX.....X....X...X....X...XX
...X..............X.....X......XX......X...X....X......XX......XXX....X....X..XX...X...
........XX..X.......X...X.XXX...X..X......XX..X.X.XXXX....XXX...XXX...X..X.X...........
..X.........X..X...XX.X...XXX.X.X.....X...XXX.X......XXX......X...XXX..XXX.X..X.....XXX
XXX.....X...XX.XXX..X.......X.....XX......XXX....X.....XXX.X.........X..XX.X....X.XX...
XXXXX.....X....XXXX....XX......XXXX..X.........XXX..X....X.X.X.....X.XX....X.XX...XX.X.
..............XXXXXXXX.....X........XXXXXXX..X..XXX...XX.X...X.....X.........XX......X.
.....X...X...............X.........X....XXX...X......XXX....X....X........X...X.XXX..X.
XX.....X...X.X........XX......X....X......X.X.XX...X..XX..X...XX...XX...X...X....X...X.
XX.XX......X...XXXX...X.........X..X...X....X....X....XX...XXXXX....X.X....X...X...X...
...X.......XX.......X.X...XXXX...XXX.X...XX.........XXXX.X..XX....X...X..X...XXXX...XXX
.XXX..........X.......X....XX..X.....XX..XX.......X...X..XX....XX....XXXXX..XXX...X..XX
.X...XXXX...X...XX.......X....XXX........X.....XX...X...X...X......XXXX.....X...XXXX..X
...X......X.X.XXXXXXXX.XXX......X......X.X.X.XXX.......X..X.....XXXX......X.........X..
..XXX.....X............X........XXX..X.X...X...X.X...X...X...XXXX....X.......X.X.......
X............XXX......X...XX....X....X.XX....X.....X....X..X..X...X..X.....X.X.X.X...XX
..XX.......X........X...X....XX....X...XXXX.....X.....XXX.XXX.....X..XXX.X...X....XX..X
.XXXXX.....X.XX.X......X.......X.X..XXXXXXX.X...XXXXX..XX..X.........XXX....X...X.XXX..
......XX.....XX...XX.X...XXXXX.X.XX.....XX..X.XXXXXXXX..XX.X.......X......X.X......X...
......X...X.......XX....X......X.....X.....XX.........X..X.....X...XX............X...XX
....XX..X...X.........X.....X......XX..X....X..X.........X..XX..XX....XXXX...XXX....X..
..X....XX...XX...X..............XXX...X..XX..X...XXX......XXXXX.X.....XXX....X....X....
XXXX....X......X.....X.....X..X.......X......X..XXXXXXXXX.X.......XXX.XXX.......X..X...
.....XX.X..X....XX.......XXX..X...XX....X....XX......XXXX.X......XXXX........XX..X...X.
.....XX..X......XX....X.......XX.......XX.XX.XXX.......XX.XXX....XXXXX.........X..XX...
XX.....X....X...X.....X.....X....X.XXXX...X..X............XX...X..XXXX......X...X.....X
..........X...X.X.X...XX......XXXX..X...XXX....XX.....XX...X.X....XXXXXXXX..X.X.....X.X
..X.....X....XX.......XX...X........X..XXX....X...X...XX.X...XX...X........XX..XX...X..
X...X...XX...X...X.....X.....X......XX..........X...X..........XX.X........X...XX..X...
XXX...X......X.X.......X..X......XX.XXXX.....X...X....X...XX....X.XXXXX....X.....X...XX
.........XX..X.XX......XXXX.X.X.....X....X.X...X...X....X.....X...XXXXX.X......X...XXXX
..XXXX.X..X..X..X.XX...XX...X.X.X.....X....X.......X.XX.......X....X....XXX.XX.X.....XX
X...X..XX.XXX...X..XXX....XXX...XXXX...XX.....XX.....X...XXXXX..XX.....XXX..XX........X
XXX.X...X.XXX....X.....X.........XXX.X....X......XX....X..XX...XX...X....X...XXXX...X..
........X.XX.....XX......X...XXX.XXX.X..X........X....XXX.........X...X....X..XX..X..X.
...X.........X...X..X...XX.X..XX.....XXXXXX........X..X.......X...X.....X.....XX.......
.........X.....X...XXXX.......XXX.....XX....XXX...XX.XX.......X.X......XX.X......X....X
...........XX..XXXX....XXXX.....X.....XX.X..X...X....X....XXX........X.........X..XX...
......XXX....XXXXX..X...........XX....X..X....X...X..X.......X...XX....XXX.XXX.......X.
..X...XXX.......X..XX.X............XX...XXXX....XXX..X...X.X.....X..X..X...XX...XX.XXX.
..X..X..X...XXX.X...X.X......XXXX..XXX..............XX.X...XXX.....XX..X....X.X....X...
..XX.X....XXXXX...X...X.X......X.......XX...XXX..XX..X....X.....XXX....XXXX.X.XX.......
.......XXXXX.......X....X...X....XX...XXX.X..XX..XXX.XX.X...X.X.XX..X.......X..X.......
....XX...X....XX.X...XXXXX....XX..X.X.....XX..XX.....XX...XXX......XX.X......X..X......
XXXX...X....X.X..XXX.....X.X...X..X......X....XX...XXXXX.......X.XXXX..XXXXX.XX...X....
XX.......XX.X...XXXX..XX...XXX....XX.....X.....XXX...X...X..XX...XX..X.......XXX....X..
......X.....XXXXXX..X..XXXXX..XXX..X.......XXX.........X....X...X.......XXXXX....X..XXX
.XX...X.X....X......XX.....X...XXX.XX.......XXX...X.........X.X.......X...X...XXXX.XXXX
....X.X......X.XX...XXXX...X.X...X....X...X.....X....XX.....X.XXXX..XXX...X.....XX....X
....X....XXX...XX...X........X.....X..X.X....X....XX.XX.....X...X...X...........XX....X
...XX..X...X..XX..X...X...X.....XX.XXX..X......X...X..XXX...X.....X........XXX...X...XX
....X....X..X......X....X...X...XX...X...........X.XX..X..X......XXX.....X.....X.X.....
..X...X.....XXX..X.......X........X......X......XX...X.........XX...XX...X..X....X..X..
..XX..X.X........XX....X.....X....X.X.XX.X........X..XX....X......X.X..XXXX...X.....X.X
......X.X....XXX.....X....XX..XXXXX...XX.XXX....X....XX....X.XX.......XXXXXXX...X...X..
....X...X........X.X.XX.......XXXXXXX....XXX..X....XX......X.XXXXX...X..X.........X..X.
..X....XX...X.XX.X...X....X...XXX.......XXX..X...XXXX.XXXX....XXX..XX...X...XX.XX....X.
X....X..X.X...XX..X..X....XXX.....XX.XX.XXX....X....X..X..X.X...X.....X..XX..X.....X...
.....XX...XXX...X...XX...XX...XX..X..XX.XXX.XX....X.XX....X..XX..........XXX.....X.....
.X....XXXX....X......X.X.XX.X.....X...X...X.XX.XX...X...X..X.....XX.........XXXX....X..
...XX...XX...X.....X.X....X.......XXX.....X......X....X......X..........XXX..X....X.X..
XX...XX..XX....XXXXX....X...XXX..XX..X........XX...X.....XX........X....XXXX...XX...XXX
X........XX.X...XX...........XX..XX..XXX...X.............X..XXXX.....X....XXX.....XXXXX
X.X.XXXX..X...X....XXXXX...X..X...X......XXX.XX..XX.X....X.....X..X..XXX....X...X......
..X.......XXX...X..XXXX..XXXX...X...X....XX..XXXXXX......XXXXX..X...X..X.X..XXX.XX.....
.XX.....X..XX...X..XXXX.X......XX......X....XXXX...X...XXXXX....XXX.X....X.XXX..XX.....
....XX.....XX.....XXXXX.X....X.XX.XX.X...X....XX.X.........X......X...XXXX.XXX.XXXX....
.......X....X......X..X..X...X..X....XXX...X...X.....XX......XXXX.X..X...X...X......X..
..........X......X.X...X....X...XXXXXXXX.....X.......XX..XX.....X....X.X.XXX...X...XX..
..XX..X..........X...X.XX.X.X.XXXXX...XX....X..XX..XXXX..XX.XXX....X...X..XXX....X.XXXX
X.....X.XX.....X..X....XX.X.....XX..X..X..XXX...X.....X...X..XX.......XXX...X.X........
X.XXX...XXX..X....X.X.....XXXX.....XXX....X...X...X.....X..X..X.....X.XX..X.X.....XXX..
..XXXX....X.....X...X...X..XXX...XXX......X....X....XX...X....XXXXXX..XX....XX........X
.X.....XX.X...X..X..X......XX..XXXXX..X..X.....X...XX..X.X...........X...X...X.XXX...XX
.X........X....X.X..X......XX.......X.X....X....XX..X....X......XXX..X.XXX.X.X.....X.XX
...X....XXX....X......XXX..XXXXXXXX.X...XXXX..X...X...XX....XX.......X.......XX...XX...
...X.X......XXXX.......X...XXXXX..X.X....XXXX...X....XX...X....X.XXX.....XX.XXX.X.XXXX.
.....X.X.....XXX.XXXXX...X..XXXX....X.XX...X.......X....X.X.X....XXXX.......X.....X....
..XXXX.......XXX............XXXX......XXXX...X.......X..X...XXX.......XXX.....XX....X..
