107 108
...XXXX..X...XX..XXXXXX......X....X....XX.....XXXX....XXXXXX....X...XXX......X..X....X...X...XX...X...XXX...
.X....X..X.X.....XXXX......X.X.XX.X..X........XXXX....XX...X..X...X.X...XXXX....X..X...X...X....X.X.X.XXX.X.
...XX....X.X..XX.XXXX..XX..X......XX.XXX.XXX..XXXXX...X..X.XX.XX....X....XXXX...XX....XXX..XXX..X...X.......
....XXXX...X.....X.....X..X.....XXX....X..XX..X.....X...XX....X..X.....X...XXXX.XXX...X.........XX.........X
..X........X.X...X...X.X.X..XX..X...X.....X...X....X.......XXXX.....XX........X.....XXX..............X......
..XX....XX...X.X.XX....X.X......X...X.XX....X..X...X.XXX...XX...XXX...X...X......X..X....XX....X..........X.
X....XX..XXX.....X..X....XX...X.....X......XXX.....X.......XX.X...XX.........X.X...XX.XX....X.......X.XX..X.
X.X..X...X....X....X.....X..X.XXXX......X.............XXX..XX...X..X.X.X...X.X..X..X..X.......X.....X....X..
X...X..X....X...X....X.....XX......X.XX...X.XXX.....X.....XX.....X.X...XXXXX..X...XX.XX.X...XXX....XXXX..X.X
XXX.X....XX.........XX..X.XXXXXX...X......X..XX.X...X..XX.XX.XXX.X.X....XXXXX.XX...X.XX...X.....X..XXX...X..
...........X........XXX.X....X...XX.......XX......X........X..XX...X..X.XXXXX.X..X...XXX..X..X....XXX..X....
...X..............X.XXX......X..XXX.......X....X.........X.XX..X....X.X.....X...XXXXXXXX..XX....XX..X.X...XX
XX......X......XX...X..XX...XXX.....XXXX..X....X...XXXXXXX.....X..X.....XXX.XXXXX.........X...X.XX....X.X.XX
........XXXXXX..X......XX.X.XXXX....XX....X...X..XXX......XX....X..X........XXXXX.......X...X......XXXX...XX
.XX....XX..XX...X....X.X..X.X....X..XX......X.X.X.......X.......XX.XXX...X...XXXX..XX...XX...XXX....XXXX...X
.X..XX.XX..XX......X.X...X..X...XX..XXXXXX......X.X.X...XXX.X...X..XX..X...X..XXXXX.....X..X.....XX......X..
...X..........XX......XXXX.......XXXX.....XX......X....X..X...X...XXX.XX.XX...X......X..X.....X....XXXX...X.
X.....X.....X.......X......X...X..............XX..XX.X........XX..XX..XX.XX.....XX.X.X..XXX.XXX.X....X..X...
....X...X....XXXXX.....X.....XXXXX.......X.XX.X...X..XX..XX...X...XX...........XXX...X..XX..X.....X..X.....X
.X.....X...X...XXX.X.XXX..X...XX...XX.XX.X......X...X....X..XX..X.X...X...XX......X..X..X..X..XX.XX.X...XX.X
...XX....X.....XXX...X....X.X....XXXX..X...X...........X.X.XXX......X.....XX..X.X.XXX...X....XX..XX.X.X....X
..X...X.....XXX.....XX.XX........XX..X.X.....XXX...X.X.X......XXXX.........XX.X.X..X..X.....X...XXX...X.....
.....XXXX.....X..XX..X.X.....X...XX..X.X..XX.....X...X....X.....X.......XX......XX...XX..XX.X....XXXXXX.....
...X........X..X...X...X.XXXXX.XXXX....X..XXX.....X.....X...XX....XXXX.....X..........X......XXX....XXXXXXXX
XXXXX...XX..XX......X..X............X.........XXX.X...X.....XX...X.....X.X.....X..XXX....X.X........XX..X...
...XX.X.X..XXXX...X.X..XX.....X.........XXXX..XXX.XX....XX..XX.....XX....X.....X..XX...X...X..XXXX......X.X.
...XX.X...XX....X.........X......XXX.X....X.....X....X.......XXXX....XX.X....XXX...X......XX.....X.X..X...X.
..X...XX.....XXXX..X........XX.X...X...X..X.......X..X...XXX..X...XX..X...X...X..X....X.XXXX...X...X...X..X.
.....XXXXX.....XXX.XXXXXXX...X.........X.......X.......XX...X...XXXXX.XX....X...XX..X...X..XXX.......X...XX.
.X.X.X...X...X...X.....XX..X.XX.....X....XX...X..X....X...X..XX..XX....X...XXXX.....XX..........XXX...XX.X..
.X.....X...X...X..........XX.XX...XX..X.....X...XXXXX...XXXX.....X...X...XXXX...X.X....X....XXX.....X..X.X.X
.X..X...X.........X...X......X..X....X..XX...X....XX..XX....XXXX...X.X....X.....X...X..XXX...X......XX.....X
..XXX.X...X..X..X...X..XXXX....XX.X..X.....X...X...X.....X..X.....XX.X.XX.......XX....XXX..X...XXX..X.....XX
X.XX..XX...XXXX......X....X.XXXXX...X..XXXXX.....X...X.....X..XXX..X...X...X....X..XX.XXX.XX..X....X..XXX...
X....XX..X...XX..XXX.X..X.X..XXXXXX.X...XXXX....X...XX...XXX....XX.......X.X....X.XXX...X........XXX......X.
..X..X..XXX....X.....X..X..X............X.....X...X..X...XX.....XX..XXXX........X.......XXX....X.XX....X....
.......XX...X...XXXXXX..XX.X...X..XX.XXXX..XX........X....X.XXX.....XX...XX..........X....X.X.......X..X...X
......X.......X..........X...X.X...X.....X...X...X......X.X...X...X......X.......XX....XX...X.X...XXX.X..X..
......X..X...XXXXX.....X....XX.X.X.......X....XX...XX...X...X..XX.....X..X.XXXX.....X...XX....X.X..XX.X.....
.......X.X.........X......XXXX...X..X...X...X..XX.....X..X.....XXX....X..X.X....XX......X..X..X.......X...XX
XXXXXX......XX....X...XX...XXXX...XXX.X...X.XX....X...X....X.X.....X.....X...X..XX...X....XX.........X..XX..
XXXXXXX...X....XX.X......X...X..X.X...XX....XX......X.....X..X....XX.....XXXXX..XX...X.X..X....X...X...X....
XXXX....X.XXXXX...XXXX....X....XX...X..X.....X.XXX..XX....X.....X....XXXX..X..XX...XX..XXXX....X.X..XX......
...X.XX...XXXXX..XXXX.....X.X.X........X.....X..X...XXXX......XXXX...XXXX..X...X.XX...XXXXXXXX...XX....XX...
.....XXX...X..XX....X.......X....X...X...XXXXXX...X....X...XXXXXXX..XXXXX....X.X....XX.....XXXX..XXXXXXX....
..X....X.X....X...X.XXXXXX.....X...X...XXX...XXX.....X...XXX..XX..X.....X...XX...X..X..XX.....X..X..XX...XXX
.....X...XXXX...X.....XXX..X......XXXX.....X.X.....X.XXXXXX...X...X..XX...X......XXX..X...X.X....X...X.XXX..
...X..X....X.....X.X......XX..X.XXX..XX...XX.X.XX..X..X.....X...X..X..X..X..X........XX..X..X..X.X.X.X......
....X........XXX.X...X.XX...X...X....X..X.XX...XX...X....X..XX...X.X.......XX...XX...XXX...XXXXX...X........
....X.......XXXX..X....X..X....XX.XX...XX.XXX..X..X.XX.X.X.....X.X.....XX.....XX...X.........XXXXXXX..XXXXXX
.X....XXX....XXXX.X...X..X..XX....X.....X......X.....X.....X........X.......X......X..X..XXX..XX..XXX...X...
.............X......XXX.XX.....X....XXX.XXXX.......X..X.......X...X...XX...X..XXX..X....X.....XX..X...X.X.X.
X.X....X.......X.XXXXXX....XX....X......X.......XXXXX.....XXX...X....X...X...XXXXXX..XX.X.........X.XXX.....
..X....X....X..X..XXXXXXX.....X......X..X.....XXX..XX..X...X.......X.......XX.....X.X........XXXX........X..
.......XX...XXX...X..XX......XX...XX.XXX...X.......XXX...X...X.............XX.XX....X.XX.....XXX...X.XXXXX..
XXXX.XXX....XX..X....XX..X....X.XX.......X.X....XX.X.....XX....XXXXXX.........XX.X.....X...XXX...X...X......
XXX..X...X..XX.....X.X...X..X...X...X...X..XX......X.XX.....X....XX..XX...XX.........X...X...X......XX....X.
XXX......X..X....X.X.X.X....X..X..X...X...XX..XX........X...X.....X...X.......X.......XXXXXX......XX....X...
XX.......X..X......X...XX...XX...XXX..X....X.XXXXXX...XX....X...X...X.......X..XXXXXX..XXXXX..XXX.......XX..
X..XX...........X...X..X..X.XX....XXXXX..X...XXXXX..X....X..X...X......XX....X.....XXX.........XX.X...X.....
X.XXX.XXX.XX......X.X..X....X...X....XXX....XXXXXX......XXXX..XX..XX.XX......XX........X...XXX....XXX.....X.
X.....X...XX...X....XXX..X....X....X......X.....X..X.......X.....XXX.....X...XX.X...XX.X.X.......X..XX.X..X.
......X.X..X....XX..XXX.......XX.X..X...X.........X..X...X.XXXX.......XX...X..X...X.XX...X..X....X..XX...X..
.XXX..X....X..X..X..X.....X...X..X..X..XX.XX...X....XX...X.XXXX.XX..X.X.......X...X.XXXXXX..X..XXX...XXXX..X
.....XXXXX.....X.X..X.XX......X.....XX.XX....X...X.....X......X.....X...XXXX......X.X..XXXXXXX...X.X...X..XX
....XXXX...XXX......X..X.X......XXX....XX..XXXXX...X......X.......X......X...X......X..XXX....XX...XXX.X...X
.......X.X.X....XXX.XX...X.........XX..XXX........XX.XX........XX...XXXX.....XXX.......X...XX..XX........X..
...X.....X...XXXXXX.XXX..X.......X.X.....X....X.......X....X...XX......XX........XXXXX.......X.XX.....X.....
.X...XX.....XXXXX...XX.....X.....X...XX..X..X...XXX.X...XX.X.........X......X....XXX......X....X...XX.X...XX
.....XXXX....XX.....X..XXX...X..........XXXXX...XX..X..XXX.X....XX......XXX.....XXX..X....X.X....X..X...XXXX
XXX....X...X.....X..X.XXX....XX...X..X....X.....XX.XXXXXXX...X....XXX.X.....XX....X.XX..X.X.......X....XXX..
X...X....X...X.X.X..X.....X.....X.X....X.....X.....X..XXXXXX...XX...X.....XXX..XX.X..XX.X....XXXX....XXX....
..X...X.XX.....X...XXXXXXXX.XX......X....X.X...X..X...XX........XXX.XX.....X..X......X..XXXX..X.......X.....
......X..X....X.............X....X....X.....XX....X.X..X....XXX.....X....X.X...........XXX..X.....XXX...X...
XXXX...X.X......X.X..X........X....X......X.....X......XX...XXX..X..X.XXXX.X...X..XXX....X..XXXX..XXXXXX....
XX...X...X.XXX....X..X.XXXXX....XX...XXX...XX.X..X...X..X.....X....XX.X..X...X.XXXX...XX.X......XXXXXXX..XXX
...X.........X.X.....X.XX........XXXX....X....XX...X....X.......XX..X....X........X.XXXX...XXX....XXXXX.XXXX
.XXX.XXXX.X..X...XXX...X..XXX.XX..X...X.....X.........X..........XX....X...XX.XX....X..XXX.....X...XXX..X..X
.X.....XX.X.X.........XX...XX.X...X..X..X...X...X...X...XX..XXXX.....X....XXX.X..X............X..X...X.....X
..........X...XXX.......XX.X....XXXX.X.....XXXX.X...X......XXXX....X....X...X...X...XX....X.X...XX.........X
X.......X.........XX.......X.X...XXX...X.X........X......X....X.X........X..XX....X....XX...X....X..X.......
X.....X.....XX...XXXXX........XX....XX.X..X..........X.X....X.X....XX..X.X.XXX...XX........XX.XX.X......XXX.
X...XXX..X...X.X............X.X...X.X.....X..XX....X...X..XXX....X....XX....XX....X....X....X..X...X.XX...X.
....XXXX...X...X......XX....X...X...X.X....X.XXX...X..X...XXXXXXXXXX..X...X.......XX...X....XX.....X........
.X...X....XXXXX.....X....XX.XX..XXX...XXXX.X.....X......X............XX......XXX.....XXX.....X..XX....XX...X
...X....X.......X.X.XXXXXXX.....X...XXX..X..X.....XXXX..XXX.........XX.....XX.......X........X..XXXXX.X..XXX
X..XXXX...XXX..XX.........XXXXX.............X..XX.....XXXX..XX....X.X..XXXXX..X.X...X.XXXX.......XX.....XX..
....XXXX....X......X......XXXX.....XX...XXXXXX.XXX.......X.XXX..X.....X......X..X.XXX.XXXX....XX.XX.XX......
.XX..XXX......XXXX........XXXX.XXXXX..X...XXXX.XXX...X.X.X..XXX....X........XX.....XX.....X......X..XXXXX...
...X...X...XX.......XX.......X..XX...XXXX.XXX..XXX.....X....X....X..XX...X....XX.X.X......X..X.....XXXXX..X.
XX.X.....XXXX.....X....X.XX..XX.........X.....XXXX.............X..X....X...X...X.....X.....X.....XX....X....
XX.X..XX...XXX....XXX....XX.XX......X...X......X..........XXXX....X..XXX.XX..X...XX.XX..XX.XXXX.....X....XXX
...X.....X.X...X..XX..X........X........X....X...XX.XXX...X.....X.X...XX..X.......X.XXX.XX......X.X...X...XX
.X...XX..X.......XXX.........XXX.....X..XX......XX..X....XX.......X.X...X...X...X...X......X...XX....X....XX
...XX..............X.........XXXX....X..X...XXX.XX.XX..X.XX..X..........X.....X........X...X.X.X...X...X....
X...X.X.........X..X...XXXXX......X..X..X.X...X....X...X.XX...XXXX...X.......X.......X....XX.X.X............
X.X.X.......X.X...X..X...........XX..XX...XXX.X......X......X.XXX..X...X...X...X.XX.....X..X...X....XXX.X...
X......X....X...XX..XXXX....XX...X...X..XX....X...XXXXX...X.......XX.XX....X.XX..X..X....X..X....X....X...X.
...X.......X....XX........X.XX...X...X.XXX............XXX....X.......XX......X..XX.X.....XX...XXXX.X.....X..
.X......X....XX.........X.X......XXX......X..X...X.......XXX...XXXX..XX..XX....XX....XXX..X........X...X...X
.X........X...XX......X.......X..XXX..XX..X....X.X...X.X...XX..XXXX...X.......XX..X....X..X..X....XX......XX
.X.....X....X.......X....X....XX......XX.XX....X.X.....X...XX....X..X...X........XXXXX....XX...X........XX..
.XX......X......X...XXXX.X.X........X....XX......X....X.......X....XX..XX.X...X....XXXX...XX..XX.X.......X..
....XXX....X........XXX..X.X.XX...X....XXXX.....XX..XXX.X.XX....X...XXX...X.X..XX......XX..XX..X.......X....
XX..XX..XX.....XXX..XXX....X.XXXX..XXX..XXX...X......XX.X....X....X.....XXX..X....XXXX.....XX..X..XXXX......
....X..XX...X..XX...XX.....X.....X...XX.....XXX...XX..X......X.....X...XXX...X.....XXX.........X....XX......
....X.....X...XXX...XX.....XXXXX.....XX..XXXXXXXX.....X..XXX.....X...X.....XXX.....XXX.........X....XX......
