17 19
........X..........
.X........X....XX..
.X.....X.....X....X
..X........X.XXXXXX
X.X...X............
X.X...XXXXX.XXX....
..X.......X...X..XX
.....XXX......XX.XX
XX.X...X.X.....X...
X..X.X...XXXXX.XX..
..X..XX..X......X.X
....XXXXX.......X.X
..XXXXX...X........
..X...X..........X.
..X.X....X...XXX...
....X..XXX.X.X.....
...........X...XX..
