48 48
...X..XXX..X.....XXX............XXXXX.....X.....
.X.X...XX....X.......XX.....X.........X.....X...
...X.X....X.......XXX.....X....X....XX........XX
X....X..X.....X...X....X...XXX....X..X.X.....XXX
X.....XX...XX...X....X...X......X..X.....X.X....
...XX....X...XX......X..XXX...XXXX....X..X....X.
...X......XX.........XX.....X....X....X...X...X.
..XX.XXX..X..X.....X.....X..XXXX.....X..X...XX..
.....X...XX....X.......X...X......X....XXX.....X
...X.....XX.X....XX.XXXXX..X........XX...X....XX
.XXX.XX..X..X.X.....XXX...XX..XX.......X..X...XX
..XX....X..X..X.......X..XXX...XXXXXX..XX.X...XX
X...XXX.X....XX.....X..X.....X....XX......X.....
XXX.....XXX.....XXX....X..XXXXX......X.......XX.
..X....XXX..X.X..X......X........X.........X.X..
....X..XXX....X....XXXX........X...XX.XX...X...X
......XXXX........XXX..X.X.....XX..XX....XX...XX
XXXX.....X...X......X....X...XX...XX........X.XX
.....XX..X.X.XXX......X..XX..X..X....XXXX.....XX
.XXX....XX....XX...XXXX...X.X...X..XXXX.........
.XXX.X..X...X....X..XXX.X.X...X....XX....X...X..
.X.....XX........X..XXX.X..XXX...X.....X...X.X.X
....X..XX...XX...X....X..X...X.......X..X....X..
XXX...X...X.XX.....XX....X........X..XX...X...X.
XXXX....XX...X.........XXX....X......XX.....X...
...X.X.....X...XXXXX...X....XX.....X..X.........
...X......XX..XXX..X........X..X.X..X......XXXX.
..XXX...X....X..X....XXXX.....XX.XX....X....X...
...X..X....X.X....X..X........XX.XX..X.XXXX.....
.X...XX..X.X.X.X....XX.XXXXXX..X.....X...XXX....
......XX.X.....X.X..XX.X....XX..XX.X......X.....
XXXXX.......XX...XXX...X.XX.XXX....X....X...XX..
XX....X........XXXXX.....X..X....XX.....X..XXX.X
X..XX.....XXX.....X...X..X.X...XX...X...X..X....
X...X..XX.....X...X.....XX.X.X.X....X...XX....X.
....X...XX...X..XXX..X...X...X...X....X....XX...
......X.X..X...X..X....X.....XX....X...XX.....XX
XXXX..X...X....X....XX....XX..X......X....X...XX
XXXX..XX....XX...X......XXXXX...X...XXXX........
...X..XXXX...XXX...XX...X.........XX.......X.XX.
...XXXXX.....XXX......X......X........X.X....X..
..XX..XX.XXXXX....X......X.....XXXX.X.X...X....X
...X...X...X....X......X....X....XX.........X...
.X...X...X....X......X....X...X........X......X.
....XX.....XX.XX.....X.XX....XX.X.X......X......
X...XX..XX.XX....X...X...X...XX.X.....X......X..
..XX.............X...XX......XX....X....XXX.....
.....XXXX........XXX....X............X......X...
