43 45
XX..X..X..............XXXXX...X..X...XXX.....
XX..X....X.....X..XXX.XX....X....X.X.X.......
XX....X......X....XXX....X.......X.X...XX.X..
........X.....X...XXX...XX...X.........XX.X..
.......XX...X.XXX.....X.X..X...XX...XX....X..
.....X.XX.X...X...XXXX..X........XX.XXX......
...X...XX....X..X......XX.........X..XX....X.
X....XXX...X...XX.....XXX....XX.X....XXX...X.
X...XXXX......X...X...XX..XX....X..XXX.......
X.......X...X...X...XXXX...X.......X...XX...X
X..XX...X.X.XX....XXXXX..X.......X.....XX...X
XXX....XXX..X..X......X.....X......XX.....X..
.....X.X...XX.XX.X....X...X.....XXXXX...X....
.X...X...X....X..X..XX..X....X........XX...XX
...X.......X..X.XXX.XX.......X.X.X...X...X...
XX.XX..XXXX...X..........X...X...X.X...XXXXX.
X..XXXXXXX..X......X..XX.....XXXX..XX....XX..
..XXXXX..X.XX..XX.....X...XX..XXX.X.........X
.XXXXXX....X...XX..XX.X.X.....X.....XX..X...X
.X....X...XX.X..XX.XX.X.XXXXX...XX...XX...X.X
.X.XX...XX...XX..X..X...XXXXXX..X..X..X..XX..
...X...XX....XXX.XX..........XXXX.....XX...X.
X....X....X..XXX.....XX........X..XX...X...X.
X.X......X...X....XX..X.....X....X...X.......
..XXX.XX.X.X...X..X...X..X....X....XXXX...X..
.XXXX......XXXXX.XX.XXXXXX.X....X....X..X....
...X..X.............X...XX......X.X....XX.XX.
XX.X.......X...XX.....X.....XXX.X...X.X...XX.
XX...X.....X.X..XXXX..X..XX.........X........
.......XX....XX......XX.....XX...X..XXXX...XX
..XXX....XX.X..X.....X..XXX.X....X.XXXX..X..X
X...X.XX..X....X....XX...XX...XX......X.....X
X...X..XX...XX..X........XXX......X...X.X....
.......XXXX...X....X.XXX...X....X....X..X..X.
.X...X...........X.X.XXX.X....X..X.X.X...X...
.X.XXX.....X.........X......XXXX.X.....X....X
...XXX..........X.X....XX.X...XX.XX......XX..
.....X....X.X...X...X..X..X.X....XXXX......X.
.XXX.X..X.X....XXXXXX....XX.X..XXXXXX...XX...
.....XXXX....X...X...XX.....X....XXXX.XXXX..X
......XXX..XXX.....X.X...X..X.X.....X..XXX..X
.XXXX...X....X.........X.X..X.X.X.X.XX...X...
........X....X......XXXX......X...X......X...
