11 13
.............
.XX..........
.XX...X...X..
........X.XXX
.....XX......
..X......X...
..X..X...X...
..X......X...
......X......
.X......X....
...XXX..XXX..
