14 15
........X..X...
....XXX......X.
X......X....XX.
..XX.X..XX.....
.X...XX.XX.X...
...X.......X.X.
X......X.X.....
..X.XX.X....X..
.XX.......X....
......X.X.X..X.
X...X.X........
..X......X....X
.X...X......X..
...X......X....
