11 11
...X.......
...X.......
X..X..X....
X..X.......
...X...X...
.X......XX.
.XX...X.X..
.XX.......X
.XXXX..X...
....X....X.
..X...XX...
