27 29
...X....X.....X...X..X...X...
.X...XX.X.......X....X.X.....
.XXXX...X....X.XXXXX......X..
..X....XX.X..X.XX..XXXX......
X....X.X..X.XX.XX...XX.......
..XX.....XX..X....X....X.....
......X..XXX.XXXX....X...X...
.XXXXXX..XX........X.....XXX.
..XX.....XX.X..X...X.....X...
X......X.X..XX.XXX.......X.XX
....X....X.XXX..XXXXX....X...
.X....X....XXXX...X..XX....X.
.X.X..XXX.....XX.....XX......
.....XX.....X....X....XXX...X
..X...X.........X...X..X..X..
....X....XXXXX....X....X.....
...XXX......XX.X.X....X......
.X........X........XX...XXXXX
...XXXX.......X.X...XX...X...
X.......X..XX.X...X......X.X.
..X........XX.........X..X.X.
.....XXX.X...XXX...XXX...X...
XX.X..X..X.....X.XX....X.....
XX..X...XX..X....X..X..XX.XX.
X...X....XX...X....XX..XX..X.
..XXX....X.........X...X...X.
...........X.......X...X.....
