15 17
...X..X...X......
.X....X.X......X.
....X......X.....
..X....X........X
...X.......XX...X
...X.X..XX......X
X.....XXXX..XXX..
X.X.X.......XX...
..X.XXX.....XX.X.
.X..X...X........
X..X......XXX...X
X....X.X.....XX.X
..X..X...X......X
.....XX..X..X....
.....XX..XX......
