20 20
XXXXXXXX...X....XXXX
XX.....X.X....X.XXXX
.....X......X...X...
..X....XX....X..X...
X...XX.XXXXX....XX..
...XXX.......XX.....
.X...X.X............
.....X....X...X....X
......X.....X...XX.X
.XXXX..............X
.....X.........X...X
..XX.....X..X....X..
..XX........X.X..XX.
..X..XXXXXX.....XXX.
XXX.XXX..XXX.X..X...
....XXX....X...X..XX
...XXXX.X..XX..X.X..
......X...XX...X....
....X..X...X.X....X.
..XXXX...X...X..X...
