109 111
XXX..XX....X........X...X...XXX.......X...XXX..XX......XX..X....XXXXX...X......XXX.....XXXXXXX......XXX...XXXXX
..X...X.XX...X......X.X...X.........X...X.XXX..XX....X.....X.XX...X...X......X.XXX.XXX.X..........X...X.X...XXX
....X...XX........XXX...XX.....X.......X..X....XXX...XXXXX.....XX...XXXX...X.X.......X...XXXX...X...X.......X..
.X...XXXXX.XX...X.XXX......X.....X.......X..XX..XX...X..XXX.X..XXX.......X...XXXXXX...X..X....XXX......X.......
...X.......XX.XXX........X....XXXX....X.XX.XX...X....X..X...X.XX...XX...XX.XX...X...X......X..X....X...XXXXX...
XXXX...XXXXX..X....XXX......X.XX...X..X..X.XX.X...X..X....X......XXX..X.......X.X.X....XXX....X.XX...XXXX..X...
XX...X.......XX....XX..XXXX......X.X.....X.XX.....X....XXX..XX.XX....XXXXXX.......X..XX....XX.....X..........X.
XX......XXX.........X...XXXX...XXX.X.......X..XX....X......XX..X..X..XXXX......XXX...X..X..X...XX...X.....XX...
XX....X..XX....X..X...X...XXXX...X.XXXXXX............XXXX..XX....X.....XX.X.....XX.X...XX..X.XXX........X.....X
X..XX.XX.....X.XXX............XX.X.....X..X....XX..X...X....XXX....XXX....X..XX....XX..X...X.X...XXX.XX...X....
..X.....XX.X...XXX.XXX.....X..X..XXXX..X...............X.X......X...XXX...XX......XX.....X...X..X....XXXX...XX.
....XX...X.....XXX...X...XXX.XX.XXXX..XXXX.....X....X....X.X.X....X..XX.X..XX.....X..XXXX.....X...X..........X.
XX...X.X...XX......X...XXXXX....X....XXXX....X........X......X.X...X.......XX..X..X.....X...X.X..XX........X...
...X...XX..X..X....XXX..XXXXX.....X..XXXX.XX....X....X..XXX.X....X.XXXXX....XX.X........XX....XXX..XX....X....X
.X....X...X..XX..XXXXX..XX....XX........X.XX.......X...XX...X.X....XXXX.....X......XXXX..X.X...X...X.....X..X..
....XX......XXXX........X..X..X....X....X......XXX......X......XX...X...XX....X..........X..XX...X...X...XX....
XXX....X.X...........XX...XX....X....X......X..XX...X.X....X.X..X.X...XXX..X.......XXX...XX.X........X...X...XX
...XX..X.X.XX...X..X.....XXXXX......XX...XX.X.....X.X....X...XX...X..X....XXXX.X...XX....XX...XXXX.....X...X..X
.X..X..X...X..X....XX....XXX...X.......X......XXX......XX............X.........X..X...XX.....XX....XX..XX.....X
..X.XXX...XX.....X....X......X.....XXX.X..XX.......X....X...XX.....X..X....X..XXX.X.XX.....X.XX.X..XX..XXXX.X..
X.....X.X......X....X.X.XX...X..XXXX...X..X......X....X..X.....XX.....X.......X...X.....X..X....X.......XX..X..
...XX...XX....XX.XX.....XX.X..X...X....X....X.......X.XX...X......XXX.......X....X....X.X.X.....X.X...X....XX..
.....XX..X.XX..X.X...X........X.X...X..X........X.X...X....XXXXXXXXX........XX.X.X....X.....X...X.X.X.XXXXXX...
XXXX.....X.X...X...X....XXX.........X........X....X.XXX....XXXXXX..X.........X...X..XXXXXX....XX..X.X...X....X.
..X......X.X....X.......XX...X.XX...X...X......X.XX....XXXX.....X..........X..X..X...XXXXXXX..XX......X.....XX.
....X...X..X..X...X....XXX.X...X....X.XXX.....XX...XX....XX.X.....XXXXXXXXXXX...XX.X....XXX....XXX.XX....XX....
.X....X.X.XX....XX..X......X.....X..X.XXXX.......X....X.....X..X....XX...XXXX......XX.......X......X...XX....XX
...X..X...X..XX..X....XXX....XX.......X....XXX.X.XXX....XX...X.XXXX....X.......XXXXXX.XX......X......X..X..X...
XXXX....XXX...XX...X...XX.X..XXXX....XX.X..XX..X.....X.....X.....X.....X.....X...XXXX..X....XX..XXX.....XX..XX.
XX...XX.XX....XX.....X.........XXXXX......XXX...X..........XX......XX..X...X...X.....X...X..XX..XXX...X...X....
XX.........X......X....X.........XX..X.XX....XX.X.X...XXXX.XX.....XXX.XX.X......XXXX.XX....XXX......X...X....XX
X......XX....XX.X.X....X......X...X....XXX......X...X..XXX..X...X........X....X..X...XX...XX...XXX.........X..X
X.XXXXXX..X..XX...XXX......X..X.X...XX.....XX....X.....XXXX...X......X........XX...X..XXX..X.XXXX..X.XXXX.....X
..XXXX...XX...XX..X...X...XX.X..X..X.............X.X....XXX........X...XX...X...X........X...XX...X..XXXX.X.XXX
...X.....X..X.XX..X.....XX.....XX.....X.....XX.......XX...X.XXXX...XX.......X.X.X...X..X............X.......X..
XX....X..X.......XXXXXX....XX.....X...X.X...XX....X.......X.XX...X....X.......X..X..X..XXXXXXX...X.......X.....
....X.X..XXX...X..........XXXXXX....X.....XXXX..X...XXXXXX..XX.XXX...XXXXXXX..XX.X.XX.......X....X.....X....XX.
......XXX..X...XXX...........X...........XXXXXX............XXX.XXXX.....X.....XX......XXXX..X.....X..X....X.X..
XXXX..XXX....X.....XX....X...X.......XX...X.......XXX..XX..X...X....X.X.X.....XXXXX........XXXXXX....X..X.....X
XX......X.........XX...XXX....XXXX....X.X.....XX..XXX.....XX.....XXX..X....XXX...X...XXXX...X...XXXX.XX....X...
XX.XXX....XXX.....XX...X....X......XX......XX....XXXX.X...X..XX..X...XX..X.XXX.X...X.XX...X.X.X..X...XX..X...X.
...XX..X.........X........X.X......X..XX.X..X..X...X..X.XXX......X.............X........X.....XX...XXXXXX....X.
......X..X...........XX.X.X.......XX...X....XX.......XX.X...XXX..XXXXX....XXXX.....XX........XXX....XX....X..X.
.....XX.XX....X.X.X..XX........XX.XX.X..X...XX.XX...XXX...XXXXX.XXXX...XX.......X......X.......X..X....X..XXX..
.X...X..XX..X...X...XXXXXX......X..X..X.....XX.XX.XXXXXX..........XX.X....XXX.X...XXXX.........XX...X..XXXX...X
.X..XX...XXXXX...X.....XXX...XX.XX..X.......XX....X..XXX..X...XX.....X...XXXX.X............X....XXX.X..XXX..X..
.XX.X..X..XXXX.X...X.......X....XXX.....XXX.....XX...X..X...X.X..XXXXXXX......X....X...XXX......XXX....XXX.....
..X.X..XX..XXX.X.....XX.XXXX.....XX..XX.......XXXX.X.X..X..X....X..XXXXXXX....X..X...X......X...XXX......XXX...
X.X.X......X...X....XXX..XXX.....XXX.....XXXXXXX...X....XXX..X.....XXX......X.X..XXXXX..X.....X.......X........
..X...X.......XXXXX......XXXX....XXX...X..XX.......XXXX..XX.X....X..X..XX.X.X..XXXXXXX..X....X..XX.XX...X...XXX
.XX.........X.X......XX...X...XX..X.....X.....X.......XX......X..XX...XX..X.XX.XXXXXX...XX...X.....XXX....X...X
..X.XX.X....X.X...XX....X...XXXXX...X.X.....X.X...XX.........XX.X......X.....X.X......X......X...XX.........X..
X...XX....X...XXX...XX.....XXX.....X..X...........XX.X.X...X..X.X.XXXX.....X.X............X..X....X.X.X........
XX....X.X..X..XXXXX....X.......XXX...XX..XXX...X.......X.X....X...X.....XXXX......X....X.......XX...X........XX
X..X....XX.X...X..XX..X...XXX...X...X..X.XX....X.X..X.XX......XXXXX...X..X....XXXX...X...X.X.....XXX...X...X...
X....XXX...X.X....X...X.X.....X...X....X....XX...X....XX..XXX..XXXX....X...XX...XX.X.X..XX....X..X...X.....X.X.
..X....X.XXX..XXX...X.........XX...X.............X...XX...X....XX....X.XX.......X....XX...X...X.X..X..X......X.
.....X...XXXX....X..XX...X.......X.XXX..XXXXX......X....X...XX.X...X...X....XXX...X...XX..X...X...XX..X.XXX..X.
XX.X....XXXXX..X...XXXXX.....X.....XXX.....X....X....X......XX...X....XX.XXXX.......X..X.X....XX...X..X...X..X.
XX.XX......XXXXXX....XX...X..X....XXX..XXX...XX...X..X.X....X...X...X....X.....X.......X.X.XX....X....XXX.X..X.
XX.XX..X.X.XXX....X...X.....XX.XX.XX..XX....XXX...X..X...X....X.X.XXX..XXX.X.X.XXX.......X....X....XX.......X..
XX..XX.X.......X..X.X......XX..XX.X..XXX.....X........X..XXX......XXX........X...X....X..XXX..X.......XX....X.X
X...XX....X....X....X..X...X..XXX...X......X...X...XX.XXXXX..X.X..........X........XX...XXX...X...X...XX......X
X....XX.....X....X.....X...X...X........X..XX....X..X...XXX....X..XX.XXXX.XXX.....XXXX..XXX.....X....XX....XX..
..XX..X...X...X....X.X.......X...XXXXX....XX..X.....XX....X.....X.XX..X...XX....X..XXX.XXXX..X.....X....X......
...XX..XX.X..XXXX....X.XX........XXX...X..XX....X...X..X...XXXX.X...X....XXX.......X......X....XX.........XX...
.X.X...XX.XX....XXX.XX....X.XXXX.X...XXX.XX..X....X...X..X......XX.....X....XXXXXX....X...X.....X.XX.........X.
.X...X....XXX.....X...X...X........X...X....XX.X..X..XX..........X.X....XXX...XXXXXXX....XX...X......X...X.....
.X.......X..........X.....XX...XX....X.X.......XXXX..X.........X......X..XX......XX....X....X....X...X.X...XX.X
.X.XX.X..X...X...XX...XX..X..X....X..X.X...XX....XX....XXX..........X....X.....X....XX.......X.....X...XX..X..X
......X.XXXX...X..XX..X...X.....X.X....XXX....XX....XXX.......X.....X..X...X.X....X.......XX...XX.....XX...X...
X...X...XXXXXX....XX.XX.....X.......X...XXX...XXX.......X...X.XXXXX.XX.....X....X...X.X........X..X...X..X...X.
..X....XXXX.....XX.......X....XX........XXX.X.....XXXX..XXX.X...XXX..........XX.....X...XX.XX..X......X........
.....X.XX....XX.....XXXX.X.....X...XX.....................X..X........X.........XX......X..XX.X....X..XXX.....X
.......X...X....XXX..XXX.X...X...X.........X.XXXXX.........X...X.XXXX...X...XXX......XX.X.....X.XX.XXXX...X....
.........X....X...XX...X...X.......X...X...X.........X...X.XX....X........X...X..XXXX......X..X....XXXX.X......
.....XX....XX.X...X....X........X....XXX..X............X......XX.....X.X......X..XX......X....X...XXXXX.XXXXXXX
X.....X....X..X.....XX.....XX.X..XX.XXXXX.X...............X...X...XX...X.X.XXXX......X...XXXX.X.X.....X...XX...
..X.X...X....XX..X......XX.XX..X....XXXXX......XXXX...X.....X...X..X.....X.XXXX....X...X..XXX...XXX.....X......
.XX..XX...X......X......XX...X....X..XXXXX..XX......XXX.XX.....XXX...XX....XXXXXXX..XX....XXX..X............X..
...X.....XX.XX.XXXX.....XXX.....X...........X...XXX..XX...XX.X..XXX.....XX..........XX..XXXX.......X...........
.......X.....X......X...XXX.X......X...XX...X.X......XXXX....XX.....X....X.....XXXX.....X....XX.....XX...XXX...
....X..XXX.X......XX..X..XX...XX.X...X...XX..........XX....X.....XX....X....X.......X.......XXX...X....X.......
..X...XXX..X..X...XX.....XXX..XX....XX......XX.XXXXXXX...X...X.X..X..X......X.X.XXX.XXXX....XXX.XXX..XX...XXX..
XX..XX....X...X.XXXX......X..X...XX.....X....X...X.....X.....X....X..X..XXX...X...X.XXXXXX....X...X..XX.X......
...X...XX...X...........X.X.X..X......X....X..XX....X.....X....XX....X.......XXXX......XX..X......XXX.......XX.
.XXX.......X...X......X.X...X.....X......X..X.X...X.X...X..XX......X.X.....X..XX...X......X..X.....X.....XX.X..
.XX....X.X...XX..X..X......XXXX........X.XX.....X.....XXXX.XX.XX...X..XXXXXXX.XX......X.....X...XX...X.XX.....X
....XX...X......XX....XX.X...X.....X.....X...X....XX.X........XX.XX...X...XXX..XXXX.X..XXX....X.XXX..X.....X.XX
...........XXX.....XX....X...X.......X..XX........X..X....X.........X...X...XX...XX..X.....X......X....X.X...XX
.XXXX...X......XXXXXXXX........XXXX..X......X.X...X.XXX...X...X........X..X........X.X..XX...X......X....XX....
.XX...X.X...XXXXX.........X.X....X.....XX...X.....X.X...X..X..X...XX.X.X....X...XX.X....XX.....X.XX...X.X....X.
....X.......XXX........X....X.X....X......XX...X..X......X...X..X....X...XX.X.........X.....X..X.X....X....X.X.
XX.....X.........XX....X.X.XX...X.....X..XX..X...X.....X.....X.X......X.....XXXXX.X.......X...XX...X....XX.....
...X...X.XX...XX.X..XX.X.X..XX....X.X.X...X........XXXXX..XX.X...XXXX......XXX..X...XX.......XX....XXX........X
..XXXX....X...X..X.XXX....X....X....X...X.X...X.....XX....XX....XX.......X...X.....XXX...XXX....X..X...XXXX...X
X....XX.X.X..XX....X....X......XXX.....XX.X.X.XXXXX....XX..X..X.X..XXXXXX......XXX.X...X..........XX........X..
...X.XX...X...XX..XX...........X.....XX...X.X..XXXXXX....X........XX...X..X..........X.......XXX.......XXX.....
.X.......X..X..X.......X.....XX..X........X..X.......XX....XXX.......X...XX.......X.....X....X...X.....XX....XX
..X...XX.X.XXX...X.......X.X..X....XX..X.....X..XX......XX.XX.......XXX..X..XX........X...X..X.X...XX..X..X....
X...X..X...XX.........X....XX...X..XX..X............X.XX......XX..X..XXXXX.........X..XX..X....X......XX.....X.
.......XX.....XXX.X.....XXX.....X...X....XXXX.....X...XX....XXX...XX...X......XX...X.XX.....X.....XX..X....X...
.XXXXX..X..X......X..X............X...X..XXX..X.............X...X........XXXXXXX.X...X..XXX.....X....XX.....X..
....X...XX...X.....X.....X.....X...X....XX...X.....XXXX...X.........X.....X...X......X.XXX...XX.....XX....X....
......X..XXX.......X.........XXX.X.X..XXXX.X...X.X...X..X........XX.X...X...X...X.XX...X...X.....XX....XX......
...X.....X....XXXXXX....X.XX..XX...XX....X.......XX..X...X.....X....X.X.....XX....X...X....XXX.X..XX....XXXXXXX
......XX....X....XXX..X.X.....X...XXX..X......X.....XX.X...X...X...XX.X..XX...XX....X...X..XXX....XX.XX...XXXXX
....X.....X...XX...X......XXX...X...X..X......X....X...X.....X.X....X..XXXX....XXX...X.....X...XX.......X..XXXX
..XXX..XX..........X...XX...........X..X......X..X...XXX..XX...X..X....XXXX..X.....X.....X...X........X....XXXX
