69 69
XXX..X.............X....XXXXX.....X....XXX..X.....X..XXX.....X.......
.....X.X....X......X.XX..X......X...XX..X...X...X....X...XXX.X.......
...X.....XX.X.XX...X...X.....X...X..XXX...X..XX..XXX....XX...XX......
X..X..X...X...XX.X..XX.XX......X...XXXXXXX...XXX....X.X.X..X..X.XX...
..XX....X.XXX.......XX.XX...X......XX..XX..X....X.....X.X.....X..XXX.
.XXX.XX.X.....X...X....XX...X..XX.........XX.XX...XX........X..X...X.
...X....XX...XXXX...X..X....XX.X..XX....XXX..X...........X.....XXX...
...X...X...X........X....X...X...XX...XX....XX.XXXXX...X...X....XXX..
.....X...XXXXX...XX...X......XXXX...X..X.X..X..X...X.X.X..X...X......
....XXXXXX.....X..........X...XX.....X......X....X.....XX...X........
..XXX.........XXXXXX........X....X.X.XX...X...X.....X...XX..X..XXXXXX
..X...XXX.XXX.......X.........X..X.....XX..XX...XX..XXX.X...XXXXXXX..
..X.....X......XXXX.X.X........XX........X.....XX..XXXX...X...XX.....
.....XX...XXXX....X...X..X...X..X.X...XX.....X....XXXX......X..X.X...
.....XXX..XX......XXXXXX.XXX..X...X.X..XX......XXXXXX..X....XX.....X.
X....X...XX..XXX...........XX....X..XX....XXX.........XX.X......X..X.
X.XX......X...XX........X......X...XX...XXX...XXXX....XX...X......XX.
X...X...X.....XX..X..XX.X.............X.X...XX......X.........XX..XX.
XX......XX....XXX....XX.XXX.....X...XXX...X.......X..XX...XX......X..
XX.X....XX....X....X......X.XXX.XXX.........X.X...XX.XX.X....X.XX...X
.....XX..XX...X..X....XX..X......X....XXXX..X.X.X.......X...XX..X..XX
.XX...XX.X..X....XX...XX...XXX.X...X..XX....X......XX.........X..XX..
.X..X.XX...XXXXX.X..XXX..X...X..X....XX..XX.XX.X......XX...XX..X.....
.X.XX...XXXXXX...X.XX...X.......X.X..XX...X.X..X......XX....XX.XXX...
...XXX..X...XX.....XX.....X........XX..XX.X.X........XX...X.......XX.
XXX....XX.X.....X.....XX......XX.X..X...X......XX....X..X.....X......
....X.....XXX.....X.X.X..XXXX....XX.X.X....X.X.........XX..XXX...XX..
.X....XXXXX....X..X.....X.............X..X.X.X..X...XX..XXXXXX.X.....
.XXX........XX...X...XXXX...XXXXXX.....X...X......X............XXX...
.XXXX......X....XX....XXXXX.XXXXXX..XX.X...XXXX..XXXX.........XXX....
.XXXX.X....X.X....XXX.X..XX....XXX..XX........X....X......XXX.XXX.XXX
....X....XX..X.X...XX....XXXXX.XXX........X.....X..X......XXX...X..XX
XXX....X.X..XX...X.....X...........XX..X..........X.....X..XXX..XX..X
.....XXX...XXXXXXX.......X....X........X...X.....X..X......X...XX...X
...X...XXXX..........XX....X..X.XXX..X.....XXX.X.X.....X...X....X....
.......X....X.....X.....XXX...X.XXX.....X......X...X.X.X...X..X....X.
..X......X....X.....X.......X.X...X.XX....XX..XXXX.X...XXX....X..X...
XX......X..X..X.XX.....X...XX.XX..X.X..X......XX...XX..XX.....XX....X
...X....X.X...X...XX.X...X..X....X..X.XX....X.XX...XX..X..X....X.XX.X
.XXX...XX.X.X.XX.....X....X...X..X.......X..X.......X..X....XX...X..X
.XX..X..X.....XX.X........XXX.X......XXX...X..X...X...X..X....X..X...
.X..XXX....X...X......XX........X........XXX....X.....X....X.......X.
...X.....X...X..X............X...............XX...XX....XXXX.X.....X.
..X..X.XXX...XX......XX...XX.....X........XXXXXX.....X....X..XXXX....
..X.XX..XX.......XXX......XX..XXXX..X...XXXXXXXX.X..XX.X..X.XXXXX.X..
X....XX.......X.......XXXX....X..XX...X..........X.....X.XX.....X.X..
...X...XXXX.........X.......X....X.....XX..........X......XXXXX...X..
.X.............X......XXX.X.XXXX...X.X.XX.X..........XX.X.XXXXXX.....
.X..X...X......X.X........X.XX..X....X..X....XX....XXXX..........X...
.X....X.....XX.X.XXX...X............XXX....X....X......X.....XX....X.
...XXXX.XX..XX...XXX.XX..X.X.....XXXXX........X...XXX..XXXX.....X..X.
..XXX...XX......X..X..X.XX...X.........XXXX....X......XX....X.....X..
X........X...X..X...X.......XX..X.....XX..XXXX.X.....X.....XXX.X....X
..XX...X.X...X.X..X.XX...XX.XX....XXX.XX.......XX..X...........X...XX
.X...X.....X...X.......X....XX.........X...........X..X.....XXX..X...
...X....X.XX.......XXX...X...X....XX.X........X..X......X.XXXXX......
......X.X.....X...XXXX.....X.X.X.....X..XXX...X....XXXX...XX....XXXXX
.XX...X.X...X...X.XXXX..X......X.X......X...XX..XX.......XXX.....XX..
.XX.......X..X..X..XXXX.....X.........X.....X..XXXX.........XXXX.....
.......XXXXX.......X.....XX...X...XXX....X....X.......X.X........X...
X...X...XXX...X..XXX..XX........X......X...X.XX.XX.XX.X..............
X.X.X.X.X...X....XXXX....X........XXXX.....X.XX..X.......X.....XX.XXX
X.X...X....XXXXX.....XX....XXXXX...XXXX......XXX...X...X.XXX.X....X..
.........X....X......X..X....X...X......X.X...XX.....X.X...X.........
.X.....X......X........XX.XX.X.X..X.....X...X.XX..X..X..XX.......X...
....XX.......XXX...XX.....X..X....X...XX...X..XXX...X...X...XXXX.XXX.
..X....XX.....XX.X.XXXX.XXX.X...X..XX.XX.X.X......XXX.....X.......X..
..X..X....X.X..X....XXX..XX.X.X..X..X..X.....X...XXX...X......X.X...X
..X..X..X...XX....X......XX...XX....XX....XX...X.....X...XXXX...X..XX
