87 88
..X........X...XXXX.....X......XXX..X....XX.......X..XXXXXX.....XXXXX..X............X...
....XXXX.....X......X.....XXXX..XX....X..XX.......X.....XXX.........X....X............X.
...X........X...............XXX..X.X....XXX......X..XX....X....X.XX.X...XX...........XX.
.X.....XX.XXX.X.....XX..XXX....X...X.X....X.XX.....X...X....X....XX...XXXX..XXX....XX...
.......X..X.....X......X..XXXX.XXXXX...X..X..X..X........XXXX.X....X......XX.....X....XX
X......X.......X...XX..X.....X...XXXXX.X.....XX..XX...X...XXX....X...X....XX.X.X.XXX..XX
X......X...X...X.X....X..XXX...X.......X...X...X....X.X.X..XX..X.......X..X..X.....X..XX
XXX......X...X.......X..XXXXX..X...XX....XX..X..X...X......XXXXX..X.......X.XXXXX...XXXX
..XXX...XX......X....X........XX.X...XX.....XXX....X...X.X.....XXXX..X..X.........X.....
......XXX.....X...XXXX...........X.....XXX.......X.X.....X.XXX.X..XX.X..XX.........X....
..........X.XXX........XX......XXX..X..XX..X...X...X..X......X....XX.X..X........X.....X
....X....XX......X.........X...XXXX...X...X..X.....X......X.....X....X..X....XXX....X...
......XX.X...XXX.....XXX.X.X....X.....X.X...XXXXX..X.X......X...XXX..X.....X..XXX...X.X.
...XX......X.X....XX..XX...XXXX....X..X........XXXXX.X.XX..XX..XXXX..X.X...XX.XXX.XXX.X.
....X.X........XX..XX.....XXX....X.XXX.....XXX.....X.X..X...X......XX..X...XX.XXX.....X.
XXX.....XXX........XX..XX...X........X......XX..XX.X..X.X.X.X...XX....X....XX...XX......
XX...XX...X.....XX..XXXXXXX.......X..XXXXXX.XX..X.....X...X...X.........X..X..X..X.XXX..
XX....X.....XXX.....X....XX..XX.....XXX...X..XX...X.XXXX.........XXXXX....XX.....X...X..
...XX....X.....XXXX...XX.........X....X.X....X....X....X...XXX.X..X....XX.X..XX...XX.XXX
.....X.X...XXX...X....XXXX..XX.X...X....XX.....X.......XXX...X.XX.X.......X.....X..X.XXX
..X....X.......X...X....XXXX...X..XX.X...X....XX...XXXXXXX.....XX..XXXX..XX....XXX......
..X.X.....XX...XXXX..X.......X....XX.....X....X......XXX....XXXXXX....X.....XX.XX...X...
....X.X...X..XX..X..X..X..........XXX..XXX...XX...XX.X...XX...X..XX...X......X..X.......
...X......X.XXX....XX.X...XXXXX...XXX..XXX....X..XXX........X....XX.XXX......XX.....XX..
.....X............XXX...X...X.....X....XXX..X.X.....X.....X......XX.....XXX....X....X...
XXXXX......X....XXXXX..XXXX...X.....XX.XXXX.....XXX.X.....X..XXXXXXXXXXXX....X.....XX...
..XX..XX.....XX..X..XXXX..X.....XX..XX......XX...XX.....XXX..X..X..........X..X.XX...XXX
...X.....XX..XXX..........X..X..XX.....XXX.....X.....XXXXXX.....X.....XX...XX.X.........
.X.XXXX..X...X..X.......X.XX....X..X...XXX.XX......XXXXX....XXX....XX....X....XXXXX...X.
....XXXXX..X.X......X...X.....X...XX...XXX.X..X.....XX.....X.....XXXX..X.....XXX....X...
X.X....X..XX...XXX..........X..XX........X...X...XX........X.XXXXX..XX....X....X.X......
X.X..X...XX.....XX...X......XX......X.X........X....XXX......XXX....X...X...X....X..XX..
..X..XX.....XXX...XX...X...XX....X....X.X.XX..XX..X.XX....X......XX...X.....X...XXX.XXXX
...............XX.XX.....X.XX.X....X......XX..X...X....X....XXX......XXXXX..X....XX.....
XX.....X...X......XX........X...XXXXXX...XXXX...X....X....XXXX..XX......XXXX.....XXX....
X..X.....X...XX.XXXX......X..X......X..X..XX.......XX...X......XX...X.....X..XXX...X....
..X..XX..XX..X..X..X..X...XX...X....X...X....X...X....X.XX....XXX.X....X....X....X.XX...
....XX..X....X.....X....X...XX.....X..X.XXX..X.X...X..X..X..X.XX.....X...X....X..X......
XX..XX....XX.....X...X...XX.....X....X..XXX....X..XX..XX..X.X.X..X....X....X....XXXX....
XX..XX........XX..X....X..X...X...X....XXXXXX...X.XX..XXX...X...X.....X...X..........X..
X.....XXXXX...XXX...X...X...X....XXXX........XX.......XXXX......X......X..X.X..XX.......
..X.......X...........X....XXXXX....X.XX.....XX..X....XXX..X.XX......X...X..XX....X.....
.....X.XX...X....X.XX....X........X...XX....XXX..XXXXXXXX..X..X..X...XX..X.....X..X..XXX
XX.X...XXXX...X....XX..X.......XX..X...X..X...X.........X...X....X..XXX...XXX....XX.....
...XX....XX..XX.X.........X.....XX...X....XXX...XX........X....X.XX.....X.........X.X...
....X.XX.XX...X.....XXX.X.X...X...X..X..X..XXX.....XXX...XX..X.X.X.........XXX..X...X.XX
XXX.X..X....X..X....XXX...X...XXX...XX.....XX..XX..XX..XXXXX...X...XXXXX...XXXXXXXX...XX
XX..XX....XX...X.X......XX..XXXX....X..XXXX...XXX..X..XXX....XX.......X..X..X....XX.....
XX...X..X..X.XXX...X....X..X...X.X....X.......X...XX......X..X..X...X.X.....X.XX.X...XX.
.....X..XX...XXX...X...XX....X.....XX......X..X...XXXX...X...X....X.X...XXXXX.XX...X....
.XXXXX..XX..XXXX.....X....X.....X......X.X...XX..XXXX..X.X.X....XX..X..X...X....X....X..
.X..XXX..X...XXX..XXXX..X...X......X.X.X.X....X.....X....X....X..X...XX..X...X....X....X
.X..XXX..X.X..XXX..XXX..X..XX.XX.X.X.....X..X...XXX...X.....X..X...X....X......XX...XX.X
....X....X.XX.X....X........X..X....X.X...XXXXXXX.......XXX....XX.....XX..XX..X........X
X...X.XX......X.XX...XXX....XX.XX.X...X.X.XX...X..XX...XXX...XX...X.X....X..XX........XX
..X.....XXX..........XX..XX..X....X..XX.X....X...XX..XXX...X......X.........X..X......XX
.........X.....X.XXX....XXX..X..XX....X.XXX..XX.....XX...XXXXX.........XXXX...XX.......X
...XX..X...XXX.X..XXX..XXX...X..X..XX.....X..XXXX....X...X.......X.......XXX..XX.....X..
.XXXXXXX..XX......X....X...X......X.......X...X....X.......XXXX....XX....XX....X...XXXX.
..XX......X.....XX.....X.XXXXXXX..X.XX......X.X...XX..X...X...X.X..XX.......XX...XXXXX..
X.XX.XXXX...X...X..X...X.XX...X...X....X...XX..XX..X....X...X...XXXXX........XX..X.....X
X.......XX....X...X....X....X.X.....X....XXXXX.XXX...X..XX..XXXXXXX.......XX.....X..X...
XXX.X......XX.....X.....X...X....X...XX....XXXX..XXXX..XXX......XX..XXX..........XX.X.X.
..X............XX.....X...X.XXX....X...XXX.XXX...X....XXX..X....XX......XX............X.
..XX.......X.X...XXX..XX....X...X...X..X...X...X.X.X....X....XXXXXXXXX...XXXXXXXXXXX....
..XXXX.X...X...X.....X.....X........X.X..X....XX.X......XXX............X.X....XXXXX..X..
..XXX..X.XX.......X..X.......X...XX...X.....X..X....X.......X...X....X.....XX.....X..X..
....X.XX.XX.....X............X...XX.....X...XX.XXXX....X......X.X.XX......XXX..X..X.....
.XX...XX.....XX.X.....XXXXX....X.....XX.....X..XX....X.....X..X..............XXX.X..XXX.
..X..XXX..XX.X..X.XXX....XX.X....XXX..X.......XXX.......XX.......X.......XXX.XXX...X....
X..X..XX..XX...XX.XX...X....X.XX....X.................X.....X.......XXX..X...X....XX....
...X..XX......XXX..X.X......X..........XXXXXXXXXX...X...X...X...X.X...X..X.XX...X..XX...
......XX..X...XXXX...XXXXXX.X...X..X.....X........X.X.....X.......XXX......XX.X....X....
XXX...XXX...XX..XX.....XX.....X.X...XXXX.X.....X..X....XX.XXXX...X.....X..XX..XX...X.X..
....X......X....XX..XX.....X.XX...X...XX.XXXXX.X........X.XXXX.......X....XX.X..XX......
.XX....X.....XX.XXX.X....X.X..XXX......X.X.......X....X.X..XXXXXX.X.....X....X......X.X.
.....X..XXX..XX.......XXXX..X.X......X...X....X......X..XX....X...X.X.X.XXX..X...XX.X.X.
...X..X.XX.....XXX...XXXXXX...X..X....X.....X.X.X....X.X....X...X...X.....X..X...XX...X.
.X..X......XXX...X....XXXX.....X....X...........X...XX.X.XX.X........X.XX.X....XXXXX....
.XX....XXXXX..........X....XXX..X......X.....XXXXX..XX....X....X...X...X....X.XXXX...X..
.X...XX...XX..X...X.............X.XX......XXXXXXXX.XX...X....X.....X..XX.X....X......XXX
...X....X.XXX...XXX.XX.X..X...X...X...X...X......X..X....XX.....XX....XX.X...XX..XX..XXX
X.......X.X......XX..X....X.X.......X...X.....XX.XX......X..X.......X......X..XX.XX..XXX
..XX......X.XXXX.XXX....X........XX..XX.XX.....X..XXX..X...X..XXXXX...X...X...XX....XXXX
...X.XXX....XX...X..XX..XX...XXXXXX..XX.X....X....XX...X...X....X.....X.XXX.X..XX...XXXX
XX..........X..XX...X..XX....X...X...XX.X.XXX...X....X.......XX...XX....X......X....XXXX
XXXXX.......X.....X...XXX......X...X....X.....X...X..XXXX............X....XX.....X..XXXX
