7 9
.........
.X.......
.X...X...
.X.....XX
.X..X..XX
.X.......
.........
