105 105
.........X....X...XXX.......XX..XXXXX..XXX.......X...X....X...XX.....XX....X....X..XX......X.....XX......
.XX........XX.X.X.XX..XXXX..XX......X......X.......X...XX...X....XX..X..XX.X..X....XX....X.X...X.XX..XXX.
..X.....X...X...X....XXX...XXX...XX...XXXX.....XX.....XX...XX..X....XX...X.XX....X..XX...X..X..X...X..XX.
X.X..X..XXX........X.........X.....XX..........XXXX.XX...X.........XX..X.....X......X....XX...X....XX....
..X..X.XXX.....X.X.....XX....XXXXX..X...XXX.....XXX.....XXXX....XX.XX.....XX...XXX..X.X..XXX....X......XX
.........X.XXX.X...XX...XXX...X...X..XX.....X.X.....X.X.X..X.XX.......XXXX....X.....X........X.......X...
XX..X.XX...X.......X..X.XX..X...X.XX...XX.....XXXX....X.X....XX.X...X....X..X.X.X...XX.............X...X.
XX..X..XX.....X......XX....X......X....XX.XX.X...X.X......X.......X...XX..X.X...XXX........XX.XXXX.......
XX...X.X..X.X.X...X.XXX......XXX....XXXX..X..X.X.......XX......X.X....X...X....XX....XX....XX...X..XX.XXX
...X...X.XX.....X.X.....XXX..XX..X.......XX.XX.X..X.XXXX...X.....X.X....X....X.X..X....XX.....X...XXX..XX
.X..X.....XX.........X..........X..X....X...XX.X....XXXX.X...XX......X....XX.X...XX.X.....XXX.....X..X..X
....X.X.X...XXXX...X...X......XXX.X..X..X....X...X...........X..X.....XX...X.X....X...XX...XX..X..X...X.X
XXX...X..XX......X..X.......XXX.....X..X.....XX..X.....XX.XX.X......X....X.X...XX......X...XX..X.X..X...X
...X.....XX.........X.X.....XX...X....X..X.......X..XX..X......XXXXXX..XXX..X....X.....XX..XXXXX...XXXX..
.X...X....X...XXX...X.X.....X..X...X....X..XXXXX..X...X.....X...XX..X..XXXX...X....XXX.....X..XX.........
.X.....XX..XX.XXX...X...X...X.XXX..X......XXX..XX.X.X.XXXXX...X.....X...XXXX....X.XX...XXX....XX...X...X.
.X..XX.XXX.XX...XXX.........X...X..X............X...X.X...........X...X.X....X....XX.....XXXX...XX...X...
.........X.XXX.......X...............XXXXXX...X.....X..........X..XX..X...X....X......X..XX.....XXX.....X
X.....X....X...X.X...XXXX....X...XXXXX......X..XX......X.......X.XX...XX....X..XXXXXX...X...XXXXX...XXX..
X...X.X...XX..X..X.XXX....X....X..XX.....X..XX..X..X.X...X........X...XXXX....XXX.......X.XXXX......XX...
X.....X...XXX...XX.....XXXX.X.....X...XX.XXXX...XX.X....X..X....X......XXXXX....X.......X..XX..X....XX.XX
...X....X..XX....XXXXXX.........X...X..X..XXX....X.XX.X......XXXX..X.....XXX.............X....X..X..XX...
.X.X...X...XX....X........XX.XX.XX..XX.XX.....XX.X....XX......XX......X......X...X.....X...X..X.....X....
.....X...X...X...X...........X.......X.X...XX.XX....XX......X.XX.XX.X...XXX....XXX..XX........X...X.X.XXX
X.X.....XXXX...X.XX......XXX...X.XX....X.X..X.....X.......X.X....XX.X..XX...X...XXX...XXX.XX....X.....X..
X.....X.XXX....X.XX.XX.X......X..XX.X.......XXXXX...X.....X...X..X..X.........X...X.......X..X.X.....X...
XX.X..X...X....X....X..X.XX.X.X.X.......XXX...XXXX..XXX...XX.......X..X..X........X....XX...XX...X.....X.
X..X..XX..........XXX....XX...X......XX.....X......XXXX......X.X.....XX....X...XXXX..X....XX....X..XX..X.
X.....XX.X.XXX....XX.........X.....XX....XXX......XX..X....XXX......XX..X....X.....XXX.X...X.X..X........
....X....X.XXX.X..X..XXX..XX...XXXX....X.....X....XX..X.....X...XXX..X.XX.X....X.X.......X...X.X..X.....X
.XX......X.....XXX..X.....XX..XXX...XX.........X..XX......X...X..XXX...XX......X.X....X.....XX.X....XXX.X
.XXX.....XX...XXXX....X...XX..X................X..XX...XXXX..XX..X......X..XX....X.XX.....X...........X.X
........X...X......X......XX....XX...XXX..X....X...X....XXXX.....X..XXX.X.....X.....XXXXX.....X...XXX.X.X
XXX...X...XXX..XX....X....XX...XX....XXXX...X....X....X.XX...XXX..X...X.X.........X.....X..X....X.X...X..
XXX.XXX....XXX....X....XX.XXXX.XX....X......XXX.....X.X.........X.......X......XXXX..XX.XXXX..XXX...XX...
..X...X..X..XX...XX.XX....X........X...X..........X.....X.....X......X.......X..XXXXX...XXXXX....X..X..XX
..XXX.XX....XXXX....XX......XXX.XX....X....XX........XX.XXX...X..X.....X.X......X..............X.XXXX...X
......XX..XXX..X..X....XXX......XX......X...X.XX......X.XXX...XX.......X......X......X.......X.X.XXX..X..
.XX....X.......X......X....X.........X....X...XX....X...XX..X..X..XX............XX.X..XX..XX.X.....X...X.
..X..X.........X...X....X.....XXX..............XXX..XX..XX...X....X.....XX...X.....XX......X....X....X...
X.XX.XX.X.......XXX..X....X.X.....X........XXX.XXX....XXXX.X....X...X...X......X...XX..X..........X.....X
X..X.XX.X.XXXXX.X...XXXX..X..XX...XXXXXXXX..XX...X.X.....X....X.XX..XXX...X...X..X..XX......XXXX....X....
XX...X..X.XXX...X...XXXXXX...X......XXXXX...X......X.X.X..X...X..X..XXXX....X...X...XX.XX....XXX.X.......
..X..X......X.......XXXXX..X...X........X.....X........XX.X...XX....XX..XX.XX..XX......XX..X..XX.X.X.XXXX
..X......XX.....XX..XXXXX......X...X......XX..XXXXX...X...X.......X.XX.....XXX...X....XXXXXXX....X.X.....
...XX........XX....XXXXXXXX....XXX....XX.......XXXX.X....XX..XX......X......XX.....X.......XX..X.........
.X.X.......X..X..X....XXXX..X...XXX.X..X...XX..XXXX....X.XX..XX....X.X...XX..X..X....X.XXX..........XXXXX
.....X........X..XXX..XXXX....X...X..X...X....X..X...X...XX.....X......X...X.XX...X....X....XXX...XX.....
X...XX......X..X.....X..X..XX.....XX..XX.....XX....X.XX.....X.....X........X......X.X.......XX.......XXX.
..X...XXXX..XX......XX....X........XX.........X...X.....XX....XX..XXXXX...........X.X...X...X..XXX.XX....
.XX.X.XXX..X......X.XX......XX...X....X.....X.X.XXX.X......X.........XX.....X.....X..XX.X.....XXX..XX...X
..X.X.X...X..XXXXX..XXXXXX.....XXXX...XXX.....X.XXX.XXXXX...XX.XXXXX......X...XX..XX..X.XXX..XXXX....X..X
X...X.....X....X...XXXX..X...X........XX..XX....X....X....X..X....XXX...X....X....X...X....XXX.....X.X.XX
.....X......XX...XXXXXX...XX.X...X....XX.....X.....X...XXXXX...XX.X...X....X.X....X....X...XXX.......X...
.XXX.XXX.........X....X.X.XX.XXX.X....XX.......X...XX...X.........X.XX.....X.....XXXXX...XXXXX...XX...XX.
.........X.........X....X..X...X.XXX.....X....XX...X..X....XX.XX....X..XXXXXX.........X..X.....X..XXX....
XXX.X......XXXXXX.XX.X...X..XX...XXX...X.X.XX.X....X.X...X..X.......X....X....X.X..........XX...X...X...X
XX..X...X....X....XX..XX.XX...X..XXX.......XX.X......X....X.XXX.X.....XX...X....X..X........X.X.X.....X.X
X..XXX....XX...XX...X.X..X.......X....X...X......XX....XX...XXX.......X....XXX...X.XX..XXXX.....X..X.....
X.XXX..X....XX....X.X...X..X...X...XX...X......X.XX.X.......XXXX........XX...XXX...XX......X...XXXXX.X.X.
X.XX..X..XX.XX.X....X..XX.X..XX...XXXX.........X..X.X.X.....XXX..X.....XXXXX......XX..X......X.........X.
X....XX...X....XXX...XXXX...X...X.XX...XXX.....XX.X.X.........X....X.X..X...X........XX.X.....X....XX....
.....X..X...X..XXXXX...XX..XX...X.X....XX..X......X.........X.X.XX.X....X.X.....XX....X...X.X.X.X.......X
.....X...XX.......X....X..........X.X..XX.......XX..XX......X.X.XX...XX...XX.XX...XXX.XX....X...X.X.XXX.X
XXXXX..X..X..XXX..X..........X.X....XXXX..X.....XX..X..X....X.X...XX....XX...XXX..XXX....X.XX.......XXX..
...XX.....XX.....X......XX...X.X.X..XXX..XX.XX...X....XX..X.....X.....X....XX..X.XXXX..XX..XX..X.XXXXXXX.
.X.XX.X.........X..XXX.....XXX.X.X..XXX.....X..X.X.....XX....X......XXX.....X..X....X...X...XX.X.......X.
.X..X....XX...X...X.....X..XX..X....XX......X.......XX..XX.....XX....XX...X....XXX....X...X.....X....X...
.XX....X....X..X....X.X...XXX.......X..X....XXX...X.....XX.XX.X...XX.XXX....XX.XXX.X.XX.......X...XX....X
.XX..XXXX....X...X..X..XX.....X....XX......XXXX...X..X...X....X...XX..X..X.....X.....XX..XX...X..X....X..
..X...XX...X....XX..XX..X..XX.XXX.......XX.X....X..XXX.X.XXXX.....XXX...X..X......X..XX.....X..XXX..X.XX.
X...X....X....X....X....XXX...XX..XXXXXX...X.X.....X...X..X...XX..X..X..X.XX.XX...X..XX...XXXX..XXX.X..X.
XX..XXX..XX......X...X...X.....X.......X.XX..X...X.X.XXXX......X..X.....X.XX....X....XX.......X........X.
...........XXX.........X...X.X.XX....X...X..XXXX.X.....X.....X.XXXX.......X...X...XX.....XX...XXXX...XXX.
...........X......XXX.....XX...XX.......XX....XX....X....XX......X....XX....X..X..X..X.XX...XX...X...XXX.
XXXXXXXXX....XXXX.......X....XXXX...X.......X.....X...X...X.X......X..X........X.XX....X....XX.X...XXX...
.....XXX..XXXX..........X..X..XX..X.X..X.XX....XX......XX...X.....XX.XX......X......X....X..X..XX....X..X
.X.....X....XX......XXX..X..X....X..X....X...X...X...X.....XXXX......X.....X......X...X..X..X...X.XX.XX..
...XX.......XXX.....XXXX....X..X...X..X....X......XX..X....XX....XX..X.X...XX...X.....X.......X...XX..XX.
X.....XXX....XX....XXXX..XX....X..X..XX...XX..X.X.....X...XXX.X..XX....X..XXXXX.......X...X....X..X...XX.
..XXX..XX..X.XX..X....X......X..X.X...XXX.XX....XX....XXX.XX..X.X...XXXXX.XXXX...X......X....X....X.XXX..
...X...XXX.X...XXXX.....XX......X...X........X.....XX.....XX......X.......XXX..X..XX.......X....X...X...X
XX...X...X...X..XX..XX...X....X..X.......XX....XX...X....XX..X...XX....X....X...X.XX...XX..XX....X......X
....X..X......X....X.....XXXX....X.X.....XX.X.....X.X.X..XX....X..X..X...X...XX......X....XXXXXX...X....X
....X.....X.X........XXXXXXX...XX..X..XX....X...X.....X.XXX.......XXXX...X.X.....XX....X........X..X....X
...XX.XXX...X..XXX..XX.......X....XX......XXXXX....XX..........XX..XXX.....XXX........X..X......X..X.....
.X..X..XX..X....XX..XX.....XXXXX.....XXXX...XX...X..X..X...XXX...X.XXX..XX.......X.XX.X.XX...X.........X.
.XX.XX...X...XX..XXXXXX..........X.....XX....X.X..X....X.X.XX......XXX.....XX.X....XX.X...XX.X......X....
..X......X...X...XX.....X.X..X...XXXXX.XX..X...XX....X...X....X...XX......X...X.X...X.XXX..X...XXXX...X..
X.X..XX......X.......X..X....X..XXXXXX.XXX..X....X...XX....X..X.......X.X.X.......X...XXXX...............
X.......X....X..XX.X.X.....X..X.X...XX.XX...X..X.....XX......XX..XX.X...X.....XX...........XX.X..........
...XXX.......X...X.....X.X.XX...X.X..X....X..X.XXXX..XXXX.....X...X....XXXX...XX...XXXX.......X.......XXX
.X..XXXX.......X..X......X......X..X...X..XX................X...X.......X...XX...X....X...X......X....XXX
.XX...X.....XXXXX.X.....XX..X......X....XXX...XX...XX.....X....XX..XX...X.XXXX.....XX.X.......XX.....XXXX
.XX...X.XX...X......X.....X...XX......X...X.XX...X..X.X...X..X..X...XXXXX.......X...X....X........XX.....
.XX.....XX.X.....X.....XX...........X..X....X.....X...XXX..X....X.X.X......XX.....X..XXX.X.XXX.XXX..XXXX.
..X..X........X..X...X.........XXXX....X.X....X.X.....XXXX....X.....X....X..X..X...X.....X.....X....XX...
X..XXX....X.....X..X....XXXXX..XXXX..X...X..XX..XX........X......XXXX..X.XX..X..XX..X...XXX......XX....XX
...XXXXX..XXXX....X.....X...XX..XXXX....XX..X..XX..X.X.........X..XXXX.....X..X...X...X.............X..XX
.X...X...XXXX....XX.X.....X.XX..XX....X..X..X.....XX...XXX.XXX..X.X...........XX.....XXXXX.XX.....X.XXXXX
.X.X.X...XXXX.....X...XX..X.X...X......X.X.......XXX..XXX..XXXX...X.X.....XXX....X.X...X...X..X.X........
.X.X.....XX...XXX.........X...X...X....X...XX....XXX......X...X..X......X.....X....X.....X...XX....X.....
...XX....XX.X..X.......XX.XX..XX....X...X.....X......X....X.X.X....X.XXXX.XX..XXX.....XX....X...XX......X
X..XX....X..XX...X...XXX..X........X..X.X.XX..X.XX.....XX...X.X.X..X..XX..X...X.....X.....X.X.X.....XXX.X
X..XXXX..X.........X.....XX..........XX...XX..X....XX..XXX..X...X..XX....XX...X.......XXX...X...........X
